A	một
Abandon	từ bỏ
Ability	có khả năng
Abioseston	chất vô cơ lơ lửng
Abiotic	vô sinh
Abiotrophic	kiệt sức sống
Abirritant	thuốc giảm kích thích
Abirritate	giảm kích thích
Abirritation	sự giảm kích thích
Abject	hèn hạ, thấp hèn, đê tiện, đáng khinh
Abjection	sự hèn hạ, sự thấp hèn, sự đê tiện
Abjectly	hèn hạ, đê tiện
Abjectness	sự hèn hạ, sự thấp hèn, sự đê tiện, sự đáng khinh
Abjudicate	tuyên bố từ bỏ
Abjuration	sự tuyên bố bỏ, sự thề bỏ
Abjurer	- xem abjure
Ablactation	sự cai sữa
Ablastous	không mầm
Ablate	cắt bỏ
Ablation	sự cắt bỏ (một bộ phận trong cơ thể)
Ablative	cách công cụ
Ablaze	rực cháy, bốc cháy
Able	có thể
Able seaman	thủy thủ hạng nhất
Able-bodied	khoẻ mạnh
Ablegate	đại sứ giáo hoàng
Ablen	cá aplet, cá vảy bạc
Ableness	năng lực, tài năng
Ablepsia	tật mù
Ablet	cá aplet, cá vảy bạc (họ cá chép)
Ablings	có lẽ, có thể
Ablins	có lẽ, có thể
Abloom	đang nở (hoa)
Abluent	rửa sạch, tẩy sạch
Ablush	thẹn đỏ mặt
Ablution	lễ rửa tội
Ably	có khả năng, có tài, khéo léo, tài tình
Abnegate	nhịn
Abnegation	sự bỏ
Abnegator	- xem abnegate
Abnormal	không bình thường, khác thường
Abnormalcy	sự không bình thường, sự khác thường
Abnormality	sự không bình thường, sự khác thường
Abnormally	dị thường, khác thường
Abnormity	sự không bình thường, sự khác thường
Abo	thổ dân
Aboard	trên tàu, trên boong tàu, trên thuyền, trên xe lửa
Aboil	đang sôi
Abolishable	có thể thủ tiêu, có thể bãi bỏ, có thể huỷ bỏ
Abolisher	người thủ tiêu, người bãi bỏ, người huỷ bỏ
Abolishment	sự thủ tiêu, sự bãi bỏ, sự huỷ bỏ
Abolitionise	làm cho theo chủ nghĩa bãi nô
Abolitionism	(sử học) chủ nghĩa bãi nô
Abolitionist	người theo chủ nghĩa bãi nô
Abolitionizea	làm cho theo chủ nghĩa bãi nô
Abomasum	dạ múi khế túi (động vật nhai lại)
Abominable snowman	người tuyết
Abominableness	sự ghê tởm, sự kinh tởm
Abominably	một cách đáng ghê tởm
Abominate	ghê tởm
Abomination	sự ghê tởm, sự kinh tởm
Abominator	xem abominate
Abonent	người thuê bao
Aboral	(sinh học) xa miệng
Aboriginal	(thuộc) thổ dân
Aboriginality	đặc điểm nguyên sơ
Aboriginally	- xem aboriginal
Aborigines	thổ dân
Abort	sẩy thai
Aborted	bị sẩy (thai)
Aborticide	thuốc giết thai
Abortifacient	phá thai, làm sẩy thai
Abortin	chất sẩy thai
Abortion	sự phá thai
Abortion mechanism	cơ năng bỏ dở
Abortionist	người phá thai
Abortive	đẻ non
Abortive subexit	lối thoát phụ khi bỏ dở
Abortively	non yểu
Abortiveness	sự đẻ non
Aboulia	chứng mất ý chí
Abounding	nhiều, phong phú, thừa thãi
About	trong khoảng
About-face	sự quay đằng sau
About-sledge	búa tạ
About-turn	sự thay đổi ý kiến, sự đổi ý
About	về
Above	ở trên
Above-board	thẳng thắn, không che đậy, không giấu giếm
Above-cited	đã dẫn, đã nhắc đến
Above-ground	ở trên mặt đất
Above-mentioned	kể trên, nói trên
Above-named	đã nói ở trên
Aboveboard	thẳng thắn, không che đậy, không giấu giếm
Aboveground	ở trên mặt đất
Abovementioned	kể trên, nói trên
Abracadabra	câu thần chú
Abrachia	tật thiếu tay
Abrachiate	thiếu tay
Abrachius	quái thai không tay
Abradant	làm mòn, mài mòn
Abrade	làm trầy (da)
Abrase	cắt mất
Abrasion	sự làm trầy (da)
Abrasive	làm trầy (da)
Abreact	giải toả mặc cảm
Abreaction	(y học) sự giải toả mặc cảm
Abreast	cùng hàng, sóng hàng, ngang nhau
Abrego	(động vật) cá ngừ vây dài
Abridge	rút ngắn lại, cô gọn, tóm tắt
Abridgement	sự rút ngắn, sự cô gọn, sự tóm tắt
Abridger	- xem abridge
Abridgment	sự rút ngắn, sự cô gọn, sự tóm tắt
Abroach	bị giùi lỗ
Abroad	ở nước ngoài
Abrogable	có thể hủy bỏ
Abrogate	bãi bỏ, huỷ bỏ, thủ tiêu
Abrogation	sự bãi bỏ, sự huỷ bỏ, sự thủ tiêu
Abrogative	bị hủy bỏ
Abrupt	bất ngờ, đột ngột
Abrupt junction	tiếp giáp dốc thẳng đứng
Abrupt junction diode	đèn hai cực tiếp giáp dốc thẳng đứng
Abruption	sự đứt rời, sự gãy rời
Abruptly	bất ngờ, đột ngột
Abruptness	sự bất ngờ, sự đột ngột, sự vội vã
Abscess	(y học) áp xe
Abscessed	(y học) bị áp-xe
Abscise	cắt ra, bị cắt ra
Absciss	(toán học) hoành độ
Abscission	(y học) sự cắt bỏ
Abscond	lẫn trốn, bỏ trốn
Absconder	người lẫn trốn, người bỏ trốn
Abseil	trèo xuống, tụt xuống
Absence	vắng mặt
Absence or presence	vắng mặt hay hiện diện, không hay có
Absent	vắng mặt, đi vắng, nghỉ
Absent service	dịch vụ (truyền đạt lúc) vắng mặt
Absent subscriber service	- (tech) dịch vụ thuê bao vắng mặt
Absent transfer	truyền đạt vắng mặt
Absent-minded	lơ đãng
Absent-mindedly	đãng trí
Absent-mindedness	sự lơ đãng, tính lơ đãng
Absentation	sự vắng mặt, trạng thái lơ đãng, không chú ý
Absentee	người vắng mặt, người đi vắng
Absently	lơ đãng
Absinth	cây apxin, cây ngải đắng
Absinthe	cây apxin, cây ngải đắng
Absinthian	(thuộc) apxin
Absolutary	xá tội
Absolute	tuyệt đối
Absolute address	địa chỉ tuyệt đối
Absolute address variable	biến số địa chỉ tuyệt đối
Absolute addressing	phương pháp định địa chỉ tuyệt đối
Absolute advantage	lợi thế tuyệt đối.
Absolute altimeter	máy đo độ cao tuyệt đối
Absolute ampere	ampe tuyệt đối
Absolute coordinate	tọa độ tuyệt đối
Absolute data	dữ kiện tuyệt đối
Absolute electrometer	điện tĩnh kế tuyệt đối
Absolute element	phần tử tuyệt đối
Absolute error	sai số tuyệt đối
Absolute expression	biểu thức tuyệt đối
Absolute file specifier	tên gọi tuyệt đối của tập tin
Absolute galvanometer	điện kế tuyệt đối
Absolute level	mức tuyệt đối
Absolute loader	bộ nạp tuyệt đối
Absolute path name	tên đường tuyệt đối
Absolute permeability	độ từ thẩm tuyệt đối
Absolute permittivity	hằng số điện môi tuyệt đối
Absolute phase	vị tướng/pha tuyệt đối
Absolute plotting	phép vẽ dùng vị trí tuyệt đối
Absolute plotting unit	đơn vị vẽ tuyệt đối
Absolute position	vị trí tuyệt đối
Absolute scarcity	khan hiếm tuyệt đối
Absolute temperature	nhiệt độ tuyệt đối
Absolute tense	thời (chế) tuyệt đối
Absolute term	số hạng tuyệt đối
Absolute unit	đơn vị tuyệt đối
Absolute value	giá trị tuyệt đối.
Absolute value computer	máy điện toán trị tuyệt đối
Absolute value function	hàm số trị tuyệt đối
Absolute vector	véctơ tuyệt đối
Absolute volt	volt tuyệt đối
Absolute zero	số không tuyệt đối
Absolutely	chắc chắn rồi
Absolutely convergent	hội tụ tuyệt đối
Absoluteness	tính tuyệt đối, tính hoàn toàn
Absolution	(pháp lý) sự tha tội, sự miễn xá
Absolutism	(chính trị) sự chuyên chế, chính thể chuyên chế
Absolutist	(chính trị) người theo chính thể chuyên chế
Absolve	tha tội, xá tội, tuyên án vô tội
Absolver	- xem absolve
Absonant	không hợp điệu, không hoà hợp
Absorb	hấp thụ
Absorbability	khả năng hút thu
Absorbable	có thể nuốt được
Absorbed	miệt mài, mê mải, say mê, chăm chú
Absorbed photon	quang tử hấp thu
Absorbed power	công suất hấp thu
Absorbedly	miệt mài, mê mải
Absorbefacient	làm tiêu đi, làm tan đi
Absorbent	hút nước, thấm hút
Absorber	thiết bị hút thu
Absorbing load	tải hấp thu
Absorbing state	trạng thái hấp thu
Absorptance	độ hấp thu
Absorption	sự hút, sự hút thu
Absorption cell	tổ hấp thu
Absorption circuit	mạch hấp thu
Absorption coefficien	hệ số hấp thu
Absorption current	dòng hấp thu
Absorption factor	hệ số hấp thu
Absorption index	chỉ số hấp thu
Absorption spectrum	quang phổ hấp thu
Absquatulate	trốn chạy
Abstain	kiêng, kiêng khem, tiết chế
Abstainer	người kiêng rượu
Abstaining	sự kiêng khem
Abstemious	tiết chế, có điều độ
Abstemiously	chừng mực, điều độ, tiết độ
Abstemiousness	sự điều độ, sự tiết độ
Abstention	sự kiêng
Absterge	tẩy, làm sạch
Abstergent	tẩy, làm sạch
Abstersion	sự tẩy sạch, sự làm sạch
Abstersive	tẩy, làm sạch
Abstinence	nhịn chi tiêu
Abstinency	thói quen ăn uống điều độ, sự kiêng khem
Abstinent	ăn uống điều độ
Abstract	trừu tượng
Abstract algebra	đại số học trừu tượng
Abstract journal	báo trích yếu, báo sao lục
Abstract noun	danh từ trừu tượng
Abstract semantics	ngữ nghĩa trừu tượng
Abstract symbol	ký hiệu trừu tượng
Abstract syntax	cú pháp trừu tượng
Abstracted	lơ đãng
Abstractedly	trừu tượng
Abstractedness	sự lơ đãng
Abstraction	sự trừu tượng, sự trừu tượng hoá
Abstractionism	chủ nghĩa trừu tượng
Abstractionist	người theo chủ nghĩa trừu tượng
Abstractness	tính trừu tượng
Abstrahent	trừu tượng, khó hiểu
Abstriction	(thực vật) sự tách rụng bào tử
Abstruse	khó hiểu
Abstrusely	thâm thúy, sâu sắc
Abstruseness	tính khó hiểu
Absurd	vô lý
Absurdity	sự vô lý
Absurdly	vô lý
Abterminal	(thực vật) xa ngọn
Abtruse	khó hiểu
Abulia	(y học) chứng mất ý chí
Abundance	sự nhiều, sự giàu có, sự phong phú
Abundant	phong phú, nhiều, chan chứa
Abundantly	nhiều
Abuse	lạm dụng
Abuser	người lạm dụng
Abusive	lạm dụng
Abusively	lăng mạ, thoá mạ
Abusiveness	sự lạm dụng
Abut	giáp giới với, tiếp giáp với
Abutilon	(thực vật học) giống cây cối xay
Abutment	giới hạn, biên giới, chỗ tiếp giáp
Abuttal	giới hạn, biên giới, chổ tiếp giáp
Abutter	(pháp lý) chủ nhà đất láng giềng (ở ngay cạnh nhà đất của ai)
Abutting	giới hạn, tiếp giáp
Abuzz	đầy tiếng rì rầm, ồn ào
Abysmal	không đáy, thăm thẳm, sâu không dò được
Abysmally	thậm tệ, cùng cực, vô cùng
Abysopelagic	thuộc vùng khơi- sâu thẳm
Abyss	vực sâu, vực thẳm
Abyssal	sâu thăm thảm, sâu như vực thẳm, sâu không dò được
Abyssobenthic	thuộc đáy biển thẳm
Ac-cut quartz	thạch anh kiểu cắt ac
Acacia	giống cây keo
Academe	học viện
Academese	phong cách hàn lâm viện
Academia	giới học viện
Academic	học tập
Academical	học viện
Academically	về mặt lý thuyết, thuần về lý thuyết
Academicals	mũ áo đại học (của giáo sư và học sinh đại học ở anh)
Academician	viện sĩ
Academy	học viện
Acaleph	loài sứa
Acanthi	cây ô rô
Acanthocarp	quả gai
Acanthocarpous	có quả gai
Acanthocephalan	sâu bọ đầu gai
Acanthocephalous	có đầu móc
Acanthocladous	có cành gai
Acanthocyst	kén gai, nang gai
Acanthoma	bướu gai
Acanthophore	cuống gai
Acanthophysis	sự rụng gai
Acanthopore	(sinh học) sự hoá gai
Acanthus	cây ô rô
Acapsular	không bao
Acardia	tật thiếu tim (bẩm sinh)
Acari	(động vật học) cái ghẻ
Acarid	(động vật) bộ ve bét| tính từ
Acarpellous	(thực vật học) không lá noãn
Acarpous	(thực vật học) không sinh quả
Acarus	(động vật học) cái ghẻ
Acas	dịch vụ trọng tài, hoà giải và cố vấn
Acatalectic	câu có số âm tiết đầy đủ (câu thơ)
Acaulescent	(thực vật) không thân cây
Acaulesent	(thực vật học) không thân (cây)
Acauline	(thực vật học) không thân (cây)
Acaulose	(thực vật học) không thân (cây)
Acaulosia	sự không phát triển thân
Acaulous	(thực vật học) không thân (cây)
Accedence	- xem accede
Acceder	- xem accede
Accelerando	(nhạc) nhanh dần
Accelerandou	(âm nhạc) nhanh lên
Accelerant	(hoá học) chất làm phản ứng hoá học xuất hiện nhanh hơn
Accelerate	đẩy nhanh
Accelerated test	- (tech) trắc nghiệm gia tốc
Accelerating	làm nhanh thêm
Accelerating anode	- (tech) dương cực gia tốc
Accelerating cavity	- (tech) cái hốc gia tốc
Accelerating coil	- (tech) cuộn dây gia tốc
Accelerating electrode	- (tech) điện cực gia tốc
Accelerating field	- (tech) trường gia tốc
Accelerating grid	- (tech) lưới gia tốc
Accelerating potential	- (tech) thế gia tốc
Acceleration	sự làm nhanh thêm, sự thúc mau, sự giục gấp
Acceleration of convergence	- (tech) gia tốc hội tụ
Acceleration parameter	- (tech) thông số gia tốc
Acceleration voltage	- (tech) điện thế gia tốc
Accelerative	làm nhanh thên, làm mau thêm
Accelerator	- (econ) gia số
Accelerator board	- (tech) bảng gia tốc, tấm gia tốc
Accelerator card	- (tech) thẻ gia tốc
Accelerator coefficient	- (econ) hệ số gia tốc
Accelerator effect	- (econ) hiệu ứng gia tốc.
Accelerator key	- (tech) khóa gia tốc, phím gia tốc
Accelerometer	- (tech) máy đo gia tốc, gia tốc kế
Accent	giọng điệu
Accented character	- (tech) chữ có dấu
Accentor	(động vật học) chim chích
Accentual	(thuộc) trọng âm
Accentually	- xem accentual
Accentuate	nhấn trọng âm, đặt trọng âm, đánh dấu trọng âm
Accentuated contrast	- (tech) sự tương phản tăng cường
Accentuation	sự nhấn trọng âm, sự đặt trọng âm, sự đánh dấu trọng âm
Accentuator	- (tech) bộ gia cường, bộ tăng sóng
Accept	Chấp nhận
Accept connection	nối nhận
Accept stacker	hộp chứa phiếu đã đọc
Accept statement	câu lệnh nhận
Acceptability	tính chất có thể chấp nhận
Acceptable	chấp nhận được
Acceptable quality level	mức độ phẩm chất chấp nhận được
Acceptableness	- xem acceptable
Acceptably	chấp nhận được, thừa nhận được
Acceptance	chấp thuận
Acceptance angle	góc thụ quang, góc nhận ánh sáng
Acceptance cone	chóp thụ quang
Acceptance inspection	kiểm tra nghiệm thu
Acceptance pattern	mô thức thụ quang
Acceptance test	thử nghiệm thu, trắc nghiệm kiểm nhận
Acceptance trials	thực nghiệm thụ quang
Acceptation	ý nghĩa đặc biệt (của một từ, thành ngữ)
Accepted	đã được thừa nhận, đã được công nhận
Accepting	nhận tin (đầu cuối)
Accepting station	trạm nhận tin
Acceptor	(thương nghiệp) người nhận thanh toán (hoá đơn...)
Acceptor center	trung tâm tiếp nhận
Acceptor circuit	mạch cộng hưởng nối tiếp, mạch nhận
Acceptor level	mức nhận
Acceptor state	trạng thái nhận
Acceptor type trap	cái bẫy loại nhận
Accesions tax	thuế quà tặng.
Accesory	phụ thêm
Access	truy cập
Access address	địa chỉ truy cập
Access arm	cần mang đầu từ
Access attempt	lần thử độ truy cập
Access barred signal	tín hiệu cản truy cập
Access category	hạng mục/loại truy cập
Access code	mã truy cập
Access control	điều khiển truy cập
Access control device	thiết bị điều khiển truy cập
Access coupler	bộ ghép truy cập
Access denial	chối bỏ/từ khước truy cập
Access digit	số mã truy cập
Access failure	thất bại truy cập
Access hierarchy	giai tầng truy cập
Access hole	khe đầu từ
Access key	phím truy cập
Access level	mức truy cập
Access list	danh sách truy cập
Access memory	bộ nhớ truy cập
Access menu	đơn chọn truy cập
Access method	phương pháp truy cập
Access mode	kiểu truy cập
Access model	mô hình truy cập
Access originator	nguồn khởi truy cập
Access path	đường truy cập
Access period	thời kỳ truy cập
Access permission	cho phép truy cập
Access phase	pha/vị tướng truy cập
Access plan	kế hoạch truy cập
Access point	điểm truy cập
Access port	bến truy cập
Access privilege	đặc quyền truy cập
Access procedure	- (tech) thủ tục truy cập
Access protocol	- (tech) nghi thức truy cập
Access rate	tốc độ truy cập
Access request	- (tech) yêu cầu truy cập
Access success	- (tech) thành công truy cập
Access success ratio	- (tech) tỉ lệ thành công truy cập
Access time	- (tech) thời gian truy cập
Access type	- (tech) loại truy cập
Access-denial probability	- (tech) xác suất từ khước truy cập
Access-denial time	- (tech) thời gian từ khước truy cập
Access-rights terminal	- (tech) đầu cuối dành quyền truy cập
Accessary	đồ phụ tùng
Accessibility	tính có thể tới được, tính có thể đến gần được
Accessible	có thể truy cập
Accessibleness	có thể truy cập
Accessibly	có thể truy cập
Accessiflexor	cơ gấp phụ
Accession	sự đến gần, sự tiếp kiến
Accessional	sự đến gần, sự tiếp kiến
Accessorial	sự đến gần, sự tiếp kiến
Accessories	phụ tùng, bộ phụ, phụ kiện
Accessorily	- xem accessory
Accessoriness	- xem accessory
Accessorius	(giải phẫu) cơ phụ
Accessory	đồ phụ tùng
Accessory software	nhu liệu/phần mềm phụ
Acciaccatura	nốt dựa
Accidence	(ngôn ngữ học) hình thái học
Accident	Tai nạn
Accident-prone	thường xảy ra tai nạn
Accidental	tình cờ, ngẫu nhiên
Accidental error	- (tech) sai số rủi ro
Accidentally	tình cờ, ngẫu nhiên
Accipiter	chim ưng
Accipitral	(thuộc) chim ưng
Accipitrine	liên quan tới chim ưng
Acclaim	tiếng hoan hô
Acclamatory	hoan hô bằng cách nhiệt liệt hoan hô
Acclimation	sự thích nghi khí hậu, sự làm hợp thuỷ thổ
Acclivity	dốc ngược
Acclivous	dốc ngược
Accolade	sự ôm hôn, sự gõ nhẹ sống gươm lên vai (khi phong tước)
Accommodate	chứa
Accommodated location	vị trí thu nhận
Accommodating	dễ dãi, dễ tính, xuề xoà
Accommodating monetary policy	chính sách tiền tệ điều tiết.
Accommodation	sự điều tiết, sự thích nghi, sự làm cho phù hợp
Accommodation address	địa chỉ tạm
Accommodation ladder	thang dây (ở bên sườn tàu thuỷ để lên xuống các xuồng nhỏ)
Accommodation limits	- (tech) giới hạn dung chứa
Accommodation train	(từ mỹ,nghĩa mỹ) xe lửa địa phương (ở địa phương)
Accommodation unit	nơi ở
Accommodation-ladder	(hàng hải) thang, thang dây (ở bên sườn tàu thuỷ để lên xuống các xuồng nhỏ)
Accommode	- (tech) thích ứng, thích nghi
Accompaniment	vật phụ thuộc, vật kèm theo
Accompanist	(âm nhạc) người đệm (nhạc, đàn)
Accompany	đi kèm
Accomplice	kẻ tòng phạm, kẻ đồng loã
Accomplish	hoàn thành
Accomplishable	- xem accomplish
Accomplished	đã hoàn thành, đã làm xong, xong xuôi, trọn vẹn
Accomplisher	- xem accomplish
Accomplishment	hoàn thành
Accord	sự đồng lòng, sự đồng ý, sự tán thành
Accordant	thích hợp, phù hợp, hoà hợp với, theo đúng với
Accorde	hòa ước
According	theo
Accordingly	do đó, vì vậy, cho nên
Accordion	(âm nhạc) đàn xếp, đàn ăccoc
Accordionist	người chơi đàn xếp, người chơi đàn ăccooc
Accost	đến gần
Accouchement	sự đẻ
Accoucheur	người đỡ đẻ
Accoucheuse	nữ hộ sinh, bà đỡ
Account	tài khoản
Account card	- (tech) thẻ chương mục
Account data	- (tech) dữ kiện kế toán, số liệu kế toán
Account level security	- (tech) an toàn mức kế toán
Account name	- (tech) tên chương mục, tên tài khoản
Account number	- (tech) số chương mục, số tài khoản
Account-holder	người nắm giữ tài khoản
Accountability	trách nhiệm giải trình
Accountable time	- (tech) thời gian đắc dụng (máy điện toán)
Accountableness	- xem accountable
Accountably	- xem accountable
Accountancy	nghề kế toán
Accountant	nhân viên kế toán, người giữ sổ sách kế toán
Accountantship	chức kế toán
Accounting	kế toán
Accouterment	(mỹ) trang bị y phục
Accoutre	mặc cho (bộ đồ đặc biệt...)
Accoutrement	bộ áo quần đặc biệt
Accoutrements	quần áo, trang phục
Accredit	làm cho người ta tin (ý kiến, tin tức, tin đồn...)
Accredited	được chính thức công nhận (người)
Accrescent	(thực vật học) cùng phát triển, cùng lớn lên
Accrete	cùng phát triển, cùng lớn lên thành một khối
Accretion	sự lớn dần lên, sự phát triển dần lên,
Accretionary	- xem accretion
Accretive	lớn dần lên, phát triển dần lên
Accrual	sự dồn lại, sự tích lại
Accruement	sự dồn lại, sự tích lại
Acculturate	tiếp biến về văn hoá
Acculturation	sự tiếp nhận và biến đổi văn hoá, sự tiếp biến về văn hoá
Accumbent	(sinh học) áp ngoài
Accumulable	- xem accumulate
Accuracy	tính chính xác
Accurate	chính xác
Accurately	chính xác
Accurateness	sự đúng đắn, sự chính xác
Accursal	sự kết tội, sự buộc tội
Accursed	đáng nguyền rủa, đáng ghét, ghê tởm
Accurst	đáng nguyền rủa, đáng ghét, ghê tởm
Accusal	sự tố cáo
Accusation	tố cáo
Accusative	(ngôn ngữ học) (thuộc) đổi cách
Accusatorial	buộc tội, kết tội
Accusatory	buộc tội, kết tội
Accuse	tố cáo
Accused	bị cáo
Accuser	uỷ viên công tố, người buộc tội
Accusingly	với vẻ cáo buộc, với vẻ tố cáo
Accustom	làm cho quen, tập cho quen
Accustomed	quen với
Ace	(đánh bài) quân át, quân xì
Acellular	không có tế bào
Acentral	- không trung tâm
Acentric	không có tâm, không có đoạn trung tâm
Acephalous	không có đầu
Acerate	có dạng kim
Acerbate	làm tăng, làm trầm trọng
Acerbic	chua chát, gay gắt
Acerbity	vị chát, vị chua chát
Acervate	(thực vật học) mọc thành chùm
Acervuline	chen chúc, dày đặc
Acescent	hoá chua
Acetabuliform	dạng cối
Acetabulum	ổ cối
Acetate	(hoá học) axetat
Acetate film	- (tech) phim axêtat
Acetic	(hoá học) axetic
Acetic acid	- (hóa) axit axetic
Acetification	sự hoá giấm
Acetifier	- xem acetify
Acetify	làm thành giấm
Acetone	axeton
Acetonic	- xem acetone
Acetous	chua, có vị giấm
Acetylen	(hóa) axetilen
Acetylene	(hoá học) axetylen
Acetylenic	- xem acetylene
Ache	sự đau, sự nhức
Acheless	không đau đớn, không đau xót
Achene	(thực vật học) quả bế
Achenial	- xem achene
Achiasmatic	không vắt tréo
Achieve	Hoàn thành
Achievement	thành tích
Achiever	- xem achieve
Achilles	a-sin (anh hùng cổ hy lạp)
Achilles heel	điểm yếu
Achilles' tendon	- (giải) gân gót
Achiness	- xem achy
Aching	sự đau đớn (vật chất, tinh thần)
Achlamydeous	(thực vật học) không bao hoa, có hoa trần
Achondroplasia	tình trạng thiếu phát triển sụn (ở người)
Achondroplastic	không tạo sụn
Achromat	- (tech) chất tiêu sắc
Achromatic	(vật lý) tiêu sắc
Achromatic color	- (tech) mầu vô sắc, mầu không sắc
Achromatic lens	- (tech) thấu kính tiêu sắc
Achromatically	- xem achromatic
Achromatism	(vật lý) tính tiêu sắc
Achromatize	(vật lý) làm tiêu sắc
Achromatous	không màu, không sắc
Achromous	(vật lý) làm tiêu sắc
Achy	bị đau nhức
Acicula	dạng kim
Acicular	hình kim
Acid	axit
Acid rain	nước mưa cay gắt do hoà lẫn các khí thải độc hại
Acid test	sự thử nghiệm giá trị, sự thử thách
Acid-proof	chịu axit
Acid-resisting	chịu axit
Acid-soluble	tan trong axit
Acidic	có tính chất axit
Acidifiable	- xem acidify
Acidification	(hoá học) sự axit hoá
Acidifier	(hoá học) chất axit hoá
Acidify	axit hoá|  nội động từ
Acidimeter	cái đo axit
Acidimetric	- xem acidimeter
Acidimetry	- xem acidimeter
Acidity	tính axit
Acidly	chua chát, gay gắt
Acidness	- xem acid
Acidofuge	(sinh học) tránh axit
Acidophilous	(sinh học) ưa axit
Acidophily	(sinh học) tính ưa axit, tính ưa chua
Acidophyte	thực vật ưa đất chua
Acidose	(y học) sự nhiễm axit
Acidosis	sự nhiễm axit
Acidotrophic	dinh dưỡng axit, ăn chất chua
Acidotropic	hướng axit, hướng chua
Acidulate	làm cho hơi chua
Acidulated	hơi chua
Acidulation	- xem acidulate
Acidulous	hơi chua
Acierage	(kỹ thuật) việc luyện thành thép, việc mạ thép
Aciform	hình kim
Acinaceous	có hạch
Acinose	nhiều hạt
Ack	khẳng định, báo nhận
Acknowledge	công nhận
Acknowledge (ack)	báo nhận, ghi nhận, báo xác định
Acknowledge character	ký tự báo nhận
Acknowledge pulse	xung báo nhận
Acknowledge request	yêu cầu báo nhận
Acknowledge state	trạng thái báo nhận
Acknowledgeable	- xem acknowledge
Acknowledgement signal	- (tech) tín hiệu báo nhận
Acleidian	(giải phẫu) không xương đòn
Aclimate	phi khí hậu
Aclinic	(vật lý) không nghiêng, vô khuynh
Acme	tột đỉnh, đỉnh cao nhất
Acne	mụn trứng cá
Acned	- xem acne
Acnode	- (hình học) điểm cô lập (của đường cong)
Acock	đội lệch (mũ)
Acold	lạnh toát
Acolyte	(tôn giáo) thầy tu cấp dưới, thầy dòng, thầy tăng
Aconite	(thực vật học) cây phụ tử
Acorn	(thực vật học) quả đầu
Acorn tube	- (tech) đèn hạt dẻ
Acorn-shaped	(thực vật) dạng quả đấu
Acotyledon	(thực vật học) cây không lá mầm
Acotyledonous	(thực vật học) không lá mầm
Acoumeter	cái đo nghe
Acoustic	(thuộc) âm thanh
Acoustic absorber	- (tech) bộ hấp thụ âm thanh
Acoustic absorption	- (tech) hấp thụ âm thanh
Acoustic admittance	- (tech) dẫn nạp âm thanh
Acoustic baffle	- (tech) ván trợ âm thanh
Acoustic capacitance	- (tech) âm dung, âm lượng
Acoustic coupler	- (tech) bộ ghép âm, bổ đổi âm sang số
Acoustic coupler modem	- (tech) bộ biến hoàn ghép âm
Acoustic dispersion	- (tech) phân tán âm thanh
Acoustic engineering	- (tech) ngành kỹ thuật âm thanh
Acoustic fidelity	- (tech) độ trung thực âm thanh
Acoustic filter	- (tech) bộ lọc âm thanh
Acoustic impedance	- (tech) trở kháng âm thanh, âm trở
Acoustic noise	- (tech) nhiễu âm
Acoustic phonon	- (tech) thanh tử âm thanh
Acoustic sensor	- (tech) bộ cảm nhận âm thanh
Acoustic wave	- (tech) sóng âm thanh
Acoustical	- (thuộc) âm thanh
Acoustically	về âm thanh, về độ vang âm
Acoustician	nhà âm học
Acquaintanceship	sự quen biết
Acquainted	quen biết, quen thuộc (với)
Acquest	vật kiếm được, của cải làm ra
Acquiesce	bằng lòng, ưng thuận, đồng ý
Acquiescence	sự bằng lòng, sự ưng thuận, sự đồng ý
Acquiescent	bằng lòng, ưng thuận, đồng ý
Acquiescently	- xem acquiescent
Acquirable	- xem acquire
Acquire	có được, thu được
Acquirement	sự được, sự giành được, sự thu được, sự đạt được, sự kiếm được
Acquirer	- xem acquire
Acquisition	mua lại
Acquisitive	thích trữ của, hám lợi
Acquisitively	- xem acquisitive
Acquisitiveness	tính thích trữ của, tính hám lợi
Acquisitor	- xem acquisitive
Acquittal	sự trả xong nợ, sự trang trải xong nợ nần
Acquittancce	sự trả nợ, sự trang trải hết nợ nần
Acquittance	sự trả nợ, sự trang trải hết nợ nần
Acral	thuộc phía đầu
Acranial	(y học) không sọ, thiếu sọ
Acraspedout	không diềm, thiếu diềm
Acre	mẫu anh (khoảng 0, 4 hecta)
Acreage	diện tích (tính theo mẫu anh)
Acrid	hăng, cay sè
Acridity	vị hăng, mùi hăng, mùi cay sè
Acridly	- xem acrid
Acrimonious	chua cay, gay gắt (lời nói, thái độ)
Acrimoniously	chua cay, gay gắt
Acrimony	sự chua cay, sự gay gắt
Acrobat	người biểu diễn leo dây, người biểu diễn nhào lộn
Acrobatic	tính chất nhào lộn, liên quan đến nhào lộn
Acrobatically	tài tình, khéo léo
Acrobatics	thuật leo dây, thuật nhào lộn
Acrocarpic	thuộc quả ngọn
Acrocarpous	(thực vật học) có quả ở ngọn
Acrocentric	thể nhiễm sắc dạng que
Acrogenous	(thực vật học) sinh ở ngọn
Acrogynous	có túi noãn ở ngọn
Acromegaly	(y học) bệnh to cực
Acronycal	(thiên văn học) xuất hiện vào lúc chập tối (sao...)
Acropetal	hướng ngọn
Acrophilous	(thực vật) ưa ngọn
Acrophily	tính ưa ngọn
Acrophobia	(y học) chứng sợ nơi cao
Acropodium	ngón (chân, tay)
Acropolis	vệ thành, thành phòng ngự
Acroscopic	(thực vật) đối ngọn
Acrospire	(thực vật) mần ngọn cuộn
Acrospore	(thực vật học) bào tử ngọn
Across	qua, ngang, ngang qua
Acrostic	(thơ ca) chữ đầu
Acrostically	- xem acrostic
Acrotropism	tính hướng ngọn
Acrylic	(hóa) acrylic
Act	hành động
Actinal	thuộc tấm toả tia
Acting	hành động
Actinia	(động vật học) hải quỳ
Actiniae	(động vật học) hải quỳ
Actinic	(vật lý),  (hoá học) quang hoá
Actinically	- xem actinic
Actinide	(hoá học) actinit
Actinidia	cây dương đào
Actiniform	(sinh học) dạng sao
Actinism	(vật lý),  (hoá học) tính quang hoá, độ quang hoá
Actinium	(hoá học) actini
Actinobiology	sinh học bức xạ
Actinoblast	(sinh học) nguyên bào gai
Actinocarpic	thuộc quả xếp toả tia
Actinocarpous	(thực vật) có quả xếp toả tia
Actinoid	dạng toả tia
Actinolit	(khoáng) actinolit
Actinometer	(vật lý) cái đo nhật xạ
Actinometric	- xem actinometer
Actinometry	- xem actinometer
Actinomorphic	(sinh vật học) đối xứng toả tia
Actinomorphous	(sinh vật học) đối xứng toả tia
Actinomorphy	- xem actinomorphic
Actinomycet	số nhiều actinomyces
Actinomycosis	bệnh do khuẩn tia
Actinon	(hoá học) actinon
Actinospore	(sinh học) bào tử toả tia
Actinotherapy	(y học) liệu pháp tia sáng
Actinotropism	(thực vật) tính hướng tia
Actinula	(sinh học) ấu trùng
Action	hoạt động
Action menu	- (tech) đơn chọn tác động
Action message	- (tech) thông báo tác động
Action painting	tranh trừu tượng được tô màu sơ sài
Action replay	sự quay một đoạn phim chậm lại để diễn tả một tình huống đặc biệt
Actionable	có thể kiện
Actionably	- xem actionable
Activate	(hoá học)
Activate indication	biểu thị khởi động
Activated	đã hoạt hoá
Activated cathode	âm cực hoạt hóa
Activated material	chất được hoạt hóa
Activated plasma	đẳng ly tử thể kích thích, plasma hoạt kích
Activating effect	hiệu ứng hoạt hóa
Activating process	xử lý khởi động
Activation	sự hoạt hoá
Activator	- xem activate
Active	đang hoạt động
Active antenna	ănten có nguồn, ănten chủ động
Active area	khu vực hoạt/năng động
Active chain	chuỗi hoạt động
Active channel	kênh có nguồn, kênh hoạt động
Active component	thành phần chủ động
Active computer	máy điện toán hoạt động
Active current	dòng hoạt tính, dòng thực
Active element	phần tử hoạt tính, phần tử chủ động
Active encapsulation	- (tech) bao bọc hoạt tính
Active file	- (tech) tập tin hoạt động, tập tin mở
Active interferometer	- (tech) giao thoa kế hoạt tính
Active material	- (tech) hoạt chất
Active medium	- (tech) môi trường hoạt tính
Active network	- (tech) mạng chủ động
Active node	- (tech) nút hoạt động
Active station	- (tech) đài có nguồn điện
Active substrate	- (tech) nền hoạt tính
Active surface	- (tech) bề mặt hoạt tính
Active task	- (tech) công việc hoạt tính, công tác hoạt tính
Active test	- (tech) phép thử hoạt động
Active time	- (tech) thời gian hoạt động
Active transducer	- (tech) bộ biến hoán/hoán năng có nguồn
Active window	- (tech) cửa sổ hoạt động, cửa sổ đang dùng
Actively	tích cực
Activeness	sự tích cực
Activism	(triết học) chủ nghĩa tích cực
Activist	nhà hoạt động
Activity	Hoạt động
Activity analysis	- (econ) phân tích hoạt động.
Activity coefficient	- (tech) hệ số hoạt động
Activity rate	- (econ) tỷ lệ lao động
Activity ratio	- (tech) tỉ số hoạt động
Actor	diễn viên
Actorish	thuộc diễn viên
Actress	nữ diễn viên
Actual	thực tế
Actual address	- (tech) địa chỉ thực tế
Actual amount	- (tech) số lượng thực tế
Actual code	- (tech) mã thực, mã tuyệt đối
Actual coding	- (tech) biên mã thực, biên mã ngôn ngữ máy
Actual data	- (tech) dữ kiện thực
Actual instruction	- (tech) chỉ thị thực
Actual parameter	- (tech) tham số thực tế
Actual power	- (tech) công suất hữu hiệu, công suất thực
Actual state	- (tech) trạng thái thực tế, thực trạng
Actual storage	- (tech) bộ trữ hữu hiệu
Actual value	- (tech) trị số thực
Actualisation	sự thực hiện, sự biến thành hiện thực
Actualise	thực hiện, biến thành hiện thực
Actuality	thực tế, thực tại
Actualization	sự thực hiện, sự biến thành hiện thực
Actualize	thực hiện, biến thành hiện thực
Actually	thực ra
Actuarial	(thuộc) chuyên viên thống kê bảo hiểm
Actuarially	- xem actuary
Actuary	chuyên viên thống kê (tỷ lệ sinh đẻ, bệnh tật, thất nghiệp...)
Actuate	thúc đẩy, kích thích
Actuating mechanism	- (tech) cơ cấu động tác, cơ chế động tác
Actuating signal	- (tech) tín hiệu phát huy
Actuating transfer function	- (tech) chức năng chuyển động tác
Actuation	sự thúc đẩy, sự kích thích
Actuator	- (tech) bộ [cần] truyền động
Acuate	khởi động (một cỗ máy)
Acuity	tính sắc nhọn (cái kim...)
Aculea	vải thô sơ
Aculeate	(thực vật học) có gai
Aculeateform	(sinh học) dạng gai
Aculeus	(sinh học) gai, trâm đốt
Acumen	sự nhạy bén, sự nhạy cảm, sự thính
Acuminate	(thực vật học) nhọn mũi
Acumination	- xem acuminate
Acumineit	làm cho nhọn
Acuminiferous	(sinh vật) có củ nhọn
Acupuncture	(y học) thuật châm cứu
Acupuncturist	chuyên gia về khoa châm cứu
Acutance	- (tech) độ phân giải, độ phân tích
Acute	sắc, sắc bén, sắc sảo
Acute accent	- (ngôn) dấu sắc (như trong café)
Acutely	sâu sắc
Acuteness	sự sắc
Acutiflorous	(thực vật) có hoa nhọn
Acutifoliate	(thực vật) có lá nhọn
Acyclic	không tuần hoàn
Acyclic graph	- (tech) đồ thị không tuần hoàn
Acyclicity	- tính không tuần hoàn, tính xilic
Acyesis	(sinh học) sự không thụ thai, sự không kết quả
Ad	quảng cáo
Ad absurdum	reduction a. a. sự đưa đến chỗ vô lý
Ad converter	- (tech) bộ đổi sóng-số
Ad hoc	đặc biệt
Ad infinitum	vô cùng, vô tận, không giới hạn, mãi mãi
Ad lib	<khngu> cương, ứng, tác
Ad nauseam	phó từ(latinh)
Ad valorem	theo giá hàng
Ad-lib	(thông tục) ứng khẩu, cương
Ada	- tên một ngôn ngữ lập trình bậc cao
Adage	cách ngôn, châm ngôn
Adagio	(âm nhạc) khoan thai
Adam	a-dam (con người đầu tiên, thuỷ tổ loài người)
Adam's apple	- (giải phẫu) trái cổ
Adamant	kỉ cương
Adamantine	rắn như kim cương
Adamantly	cứng rắn
Adamantoblast	tế bào men răng
Adamic	của hay giống thời kỳ adam
Adamite	con người
Adapt	phỏng theo
Adaptability	tính có thể tra vào, tính có thể lắp vào
Adaptable	có thể tra vào, có thể lắp vào
Adaptableness	tính có thể tra vào, tính có thể lắp vào
Adaptation	sự tra vào, sự lắp vào
Adaptation function	- (tech) chức năng thích ứng
Adaptational	- xem adaptation
Adaptationally	- xem adaptation
Adapter	người phỏng theo, người sửa lại cho hợp (tác phẩm văn học...)
Adapter board	- (tech) bảng tiếp hợp
Adaptive	- (tech) mang tính thích nghi
Adaptive equalizer	- (tech) bộ cân bằng điều ứng
Adaptive expectation	- (econ) kỳ vọng thích nghi
Adaxial	hướng trục, bên trục, gần trục, dính trục
Adb	- (vt của apple desktop bus) bus của máy tính để bàn apple, bus adb
Adc	(vt của aid to dependent children)
Adcauline	(sinh vật) bên thân, dính thân
Add	thêm vào
Add carry	- (tech) số nhớ khi cộng
Add-in	- <tin> chương trình bổ sung
Add-on	- (tech) thiết bị thêm vào, phụ kiện, phụ tùng tăng cường
Add-on memory	- (tech) bộ nhớ thêm vào
Addable	- xem add
Addax	(động vật học) linh dương sừng queo (bắc phi)
Added	thêm
Addend	số hạng (của tổng)
Addend digit	- (tech) ký số của số cộng
Addend register	- (tech) bộ ghi số cộng
Addenda	phụ lục (của một cuốn sách)
Addendum	phụ lục (của một cuốn sách)
Adder	người cộng, máy cộng
Adder accumulator	- (tech) bộ cộng tích lũy/tăng trữ
Adder amplifier	- (tech) bộ khuếch đại cộng
Adder subtracter	- (tech) bộ gia giảm, bộ cộng trừ
Adder's tongue	(thực vật học) cây lưỡi rắn (dương xỉ)
Adder-in	- (tech) phụ kiện tăng cường, phụ tùng tăng cường, tăng thiết
Adder-spit	(thực vật học) cây lưỡi rắn (dương xỉ)
Adder-subtractor	- bộ cộng và trừ
Addicted	say mê, nghiện
Addiction	thói nghiện
Addictive	- xem addict
Address	địa chỉ nhà
Addressee	người nhận (thư...)
Adduce	viện, viện dẫn (lý lẽ, thí dụ, bằng chứng...)
Adduceable	có thể viện dẫn (lý lẽ, thí dụ, bằng chứng...)
Adducible	có thể viện dẫn (lý lẽ, thí dụ, bằng chứng...)
Adductor	cơ khép
Addutor	cơ khép
Ademption	sự tước bỏ quyền thừa kế tài sản
Adenite	viêm hạch
Adenitis	viêm hạch
Adenoidectomy	giải phẫu
Adenoids	bệnh sùi vòm họng
Adept	người giỏi, người tinh thông
Adeptly	- xem adept
Adeptness	- xem adept
Adequacy	sự đủ, sự đầy đủ
Adequate	đầy đủ
Adequately	tương xứng, thích đáng, thoả đáng
Adequateness	sự đủ, sự đầy đủ
Adequation	sự san bằng
Adespota	những tác phẩm khuyết danh
Adhere	dính chặt vào, bám chặt vào
Adherence	sự dính chặt, sự bám chặt
Adherent	người gia nhập đảng, đảng viên, môn đồ
Adherently	- xem adherent
Adherer	người gia nhập đảng, đảng viên, môn đồ
Adhesion	sự dính chặt vào, sự bám chặt vào
Adhesive	dính, bám chắc
Adhesive tape	- (tech) băng dính
Adhesively	- xem adhesive
Adhesiveness	dính dính
Adhibit	ký (tên) vào
Adi	- (apple desktop interface) giao điện máy tính để bàn apple, giao diện adi
Adiabat	- (tech) đường đoạn nhiệt
Adiabatic	(vật lý) đoạn nhiệt
Adiantum	(thực vật học) cây đuôi chồn (dương xỉ)
Adiastiole	(y học) sự suy tâm trương
Adic	- ađic
Adience	(sinh học) sự hướng kích thích
Adient	(sinh vật) hướng kích thích
Adieu	từ biệt!
Adinfinitum	vô cùng
Adios	xin từ biệt!
Adipocere	chất sáp mỡ (xác chết)
Adipocyte	tế bào tạo mỡ
Adipoleucocyte	bạch cầu-mỡ
Adipolysis	sự tiêu mỡ
Adipopexis	sự tích mỡ
Adiposeness	- xem adipose
Adiposis	(y học) chứng phát phì
Adiposity	tình trạng béo phì, tình trạng phát phì
Adit	đường vào, lối vào
Aditus	cửa
Adj	(viết tắt adjective) phụ vào, thêm vào, lệ thuộc, không đứng một mình
Adjacence	sự gần kề, sự kế liền
Adjacency	sự gần kề, sự kế liền
Adjacent angles	- (toán) góc kề
Adjacently	cận kề nhau
Adjectival	(ngôn ngữ học) có tính chất tính từ
Adjectivally	như một tính từ, theo cách thức của một tính từ
Adjective	phụ vào, thêm vào
Adjectively	- xem adjective
Adjgate	- liên hợp, phù hợp
Adjudgment	sự xét sử, sự phân xử
Adjudicate	xét xử (quan toà)
Adjudication	sự xét xử
Adjudicative	- xem adjudicate
Adjudicator	quan toà
Adjunct	điều thêm vào, cái phụ vào
Adjunct professor	(từ mỹ,nghĩa mỹ) trợ giáo
Adjunction	sự thêm vào, sự phụ vào
Adjunctive	thêm, phụ vào
Adjuration	lời thề, lời tuyên thệ
Adjuratory	- xem adjuration
Adjure	bắt thề, bắt tuyên thệ
Adjurer	- xem adjure
Adjuror	- xem adjure
Adjust	điều chỉnh
Adjustable	có thể điều chỉnh được
Adjustable array	dẫy/mảng điều chỉnh được
Adjustable capacitor	bộ điện dung chỉnh được
Adjustable dimension	kích thước điều chỉnh được
Adjustable peg regime	chế độ điều chỉnh hạn chế.
Adjustable probe	đầu dò điều chỉnh được
Adjuster	máy điều chỉnh
Adjusting	điều chỉnh
Adjusting screw	vít điều chỉnh
Adjustment	điều chỉnh
Adjustment cost	- (econ) chi phí điều chỉnh sản xuất.
Adjustment table	- (tech) bảng điều chỉnh
Adjustor	- xem adjust
Adjutage	ống vòi (ống nhỏ lắp vào miệng vòi máy nước để lấy nước)
Adjutancy	(quân sự) chức sĩ quan phụ tá
Adjutant	người phụ tá
Adjutant general	sự quan quản trị cao cấp trong quân đội
Adjuvant	giúp đỡ, phụ tá, giúp ích
Adm	- (viết tắt của admiral) đô đốc
Admass	quần chúng dễ bị thủ đoạn quảng cáo ảnh hưởng
Admeasure	quy định từng phần
Admeasurement	sự quy định từng phần, sự chia phần
Admeasurer	- xem admeasure
Adminiculum	(động vật) gai vận động
Administer	quản lý
Administrable	- xem administer
Administrant	- xem administer
Administrate	(từ mỹ,nghĩa mỹ) trông nom, quản lý
Administration	quản trị
Administration information display	- (tech) bộ hiển thị tin tức quản lý
Administration manager	- (tech) quản trị viên hành chính
Administration mode	- (tech) chế độ quản lý
Administration process	- (tech) quy trình quản lý
Administration program	- (tech) chương trình quản lý
Administrative	hành chính
Administrative information	- (tech) tin tức quản lý
Administrative service	- (tech) dịch vụ quản lý
Administratively	về mặt hành chính
Administrator	người quản lý
Administratorship	chức vụ quản lý
Administratrices	bà quản lý
Administratrix	bà quản lý
Admirability	tính đáng phục, tính đáng khâm phục, tính đáng ca tụng
Admirable	đáng phục, đáng khâm phục, đáng ca tụng
Admirableness	tính đáng phục, tính đáng khâm phục, tính đáng ca tụng
Admirably	đáng phục, đáng ngưỡng mộ
Admiral of the fleet	tổng tư lệnh hải quân
Admiralship	chức đô đốc
Admiralty	(anh) bộ hải quân
Admiration	sự ngắm nhìn một cách vui thích
Admire	ngưỡng mộ
Admirer	người khâm phục, người cảm phục, người thán phục
Admiring	khâm phục, cảm phục, thán phục
Admiringly	khâm phục, thán phục, ngưỡng mộ
Admissibility	tính có thể chấp nhận được, tính có thể thừa nhận được
Admissible	có thể chấp nhận, có thể thừa nhận
Admissible function	hàm số chấp nhận được
Admissible hypothesis	giả thuyết chấp nhận được
Admissibleness	- xem admissible
Admissibly	- xem admissible
Admission	nhận vào
Admissive	- xem admission
Admit	thừa nhận
Admittable	có thể để cho vào (nơi nào)
Admittance	sự cho vào, sự để cho vào
Admitted	tự nhận
Admittedly	phải nhận, phải thừa nhận, phải thú nhận
Admix	trộn lẫn, hỗn hợp
Admixture	sự trộn lẫn, sự hỗn hợp
Admonish	khiển trách, quở mắng, la rầy
Admonisher	- xem admonish
Admonishingly	- xem admonish
Admonishment	sự khiển trách, sự quở mắng, sự la rầy
Admonition	sự khiển trách, sự quở mắng, sự la rầy
Admonitory	khiển trách, quở mắng, la rầy
Adnate	(sinh vật học) hợp sinh
Adnation	- xem adnate
Adnexa	cấu trúc ngoại phôi; màng phụ
Adnexed	(sinh học) đính thân
Adnominal	- xem adnoun
Adnoun	(ngôn ngữ học) tính từ, danh tính từ
Ado	việc làm, công việc
Adobe	gạch sống (phơi nắng, không nung)
Adolescaria	(động từ) ấu trùng kết kén
Adolescence	thời thanh niên
Adolescency	thời thanh niên
Adolescent	thanh niên
Adonize	làm dáng vẻ người đẹp
Adopt	thông qua
Adoptability	tính có thể nhận làm con nuôi
Adoptable	có thể nhận làm con nuôi
Adoptee	con nuôi
Adopter	người nhận nuôi
Adoption	nhận con nuôi
Adoptive	nuôi
Adorability	tính đáng yêu, tính đáng quý mến, tính đáng yêu, tính đáng quý mến
Adorable	đáng kính yêu, đáng quý mến, đáng yêu
Adorableness	tính đáng yêu, tính đáng quý mến, tính đáng yêu, tính đáng quý mến
Adorably	đáng mến, đáng yêu
Adoration	sự kính yêu, sự quý mến
Adore	kính yêu, quý mến
Adorer	người hâm mộ, người yêu chuộng, người yêu
Adoring	tha thiết
Adoringly	tha thiết, trìu mến
Adorn	tô điểm, trang điểm
Adorner	- xem adorn
Adornment	sự tô điểm, sự trang trí, sự trang hoàng
Adown	(từ cổ,nghĩa cổ)
Adp	truy cập dữ liệu tự động (automatic  data  proccessing)
Adpressed	(thực vật) ôm sát
Adrectal	(giải phẫu) gần ruột thẳng
Adrenal	(giải phẫu) trên thận, thượng thận
Adrenal gland	- (giải phẫu) tuyến thượng thận
Adrenalectomy	(giải phẫu) việc cắt tuyến trên thận
Adrenalin	(y học) adrenalin
Adrenally	- xem adrenal
Adrenocorticotrophic	- kích thích thượng thận
Adrift	lênh đênh trôi giạt, phiêu bạt
Adroit	khéo léo, khéo tay
Adroitly	khéo léo
Adroitness	sự khéo léo, sự khéo tay
Adromia	sự mất kích thích
Adscititious	phụ vào, thêm vào, bổ sung
Adsl	- mạng thuê bao số không đồng bộ
Adsorb	(hoá học) hút bám
Adsorbable	- xem adsorb
Adsorbate	(hoá học) chất bị hút bám
Adsorbent	(hoá học) hút bám
Adsorber	(hoá học) máy hút bám
Adsorption	(hoá học) sự hút bám
Adsorptive	- xem adsorption
Adt	thời gian ban ngày ở đại tây dương (atlantic daylight time)
Adularia	(khoáng chất) trong suốt
Adulate	nịnh hót, nịnh nọt, bợ đỡ
Adulation	sự nịnh hót, sự nịnh nọt, sự bợ đỡ
Adulator	kẻ nịnh hót, kẻ nịnh nọt, kẻ bợ đỡ
Adulatory	nịnh hót, nịnh nọt, bợ đỡ
Adult	người lớn
Adulterant	để làm giả
Adulterate	có pha (rượu)
Adulteration	sự pha, sự pha trộn
Adulterator	- xem adulterate
Adulterer	người đàn ông ngoại tình, người đàn ông thông dâm
Adulteress	người đàn bà ngoại tình, người đàn bà thông dâm
Adulterous	ngoại tình, thông dâm
Adulterously	- xem adulterous
Adultery	tội ngoại tình, tội thông dâm
Adulthood	tuổi khôn lớn, tuổi trưởng thành
Adultlike	có vẻ trưởng thành
Adultness	- xem adult
Adultoid	dạng trưởng thành
Adumbral	nhiều bóng râm
Adumbrate	phác hoạ
Adumbration	sự phác hoạ, bản phác hoạ
Adumbrative	- xem adumbrate
Adumbratively	- xem adumbrate
Aduncate	- cách viết khác
Adust	cháy khô, khô nứt ra (vì ánh mặt trời...)
Advancement	sự tiến lên, sự tiến tới, sự tiến bộ
Advantage	lợi thế
Advantageous	có lợi, thuận lợi
Advantageously	thuận lợi, ích lợi
Advantageousness	tính có lợi, tính thuận lợi
Advantege	- trội hơn ưu thế
Advection	(khí tượng) bình lưu
Advehent	đồng tâm
Advene	đến
Advent	sự đến, sự tới (của một sự việc gì quan trọng)
Adventism	chúa sắp tái giáng sinh
Adventist	tín đồ tin rằng sắp đến lần giáng sinh thứ hai của chúa
Adventitia	vỡ mạch máu
Adventitious	ngẫu nhiên, tình cờ
Adventitiously	- xem adventitious
Adventitiousness	tính ngẫu nhiên, tính tình cờ
Adventure	cuộc phiêu lưu
Adventure playground	sân chơi có nhiều đồ chơi bằng gỗ và kim loại
Adventurer	người phiêu lưu, người mạo hiểm, người thích phiêu lưu mạo hiểm
Adventuresome	(từ hiếm,nghĩa hiếm) (như) adventurous
Adventuress	người đàn bà thích phiêu lưu mạo hiểm
Adventurism	chủ nghĩa phiêu lưu
Adventurist	- xem adventurism
Adventurous	thích phiêu lưu, thích mạo hiểm, phiêu lưu, mạo hiểm
Adventurously	liều lỉnh, mạo hiểm
Adventurousness	tính phiêu lưu, tính mạo hiểm
Adverb	(ngôn ngữ học) phó từ
Adverbe	(ngôn ngữ) phó từ
Adverbial	(ngôn ngữ học) (thuộc) phó từ
Adverbially	như một phó từ, theo cách thức của một phó từ
Adversary	kẻ địch, kẻ thù
Adversative	(ngôn ngữ học) đối lập
Adversatively	- xem adversative
Adverse balance	- (econ) cán cân thâm hụt.
Adverse selection	- (econ) lựa chọn trái ý
Adverse supply shock	- (econ) cú sốc cung bất lợi.
Adversely	bất lợi
Adverseness	- xem adverse
Adversity	sự bất hạnh
Advert	ám chỉ (nói hoặc viết)
Advertence	sự chú ý, sự lưu ý
Advertency	sự chú ý, sự lưu ý
Advertent	lưu ý
Advertise	báo cho biết, báo cho ai biết trước
Advertisement	sự quảng cáo
Advertiser	người báo cho biết trước
Advertising	sự quảng cáo, nghề quảng cáo
Advise	khuyên nhủ
Advised	am hiểu, hiểu biết
Advisedly	có suy nghĩ chín chắn, thận trọng
Adviser	cố vấn
Advisor	người khuyên bảo, người chỉ bảo, cố vấn
Advisory	để hỏi, để xin ý kiến
Advocacy	nhiệm vụ luật sư
Advocate	biện hộ
Aeolation	sự phong hoá
Aeolian	thông gió
Aeolight	- (tech) đèn phát sáng âm cực lạnh
Aeon	thời đại, niên kỷ
Aerate	làm thông khí, quạt gió
Aeration	sự làm thông, sự quạt gió
Aerenchyma	(sinh học) mô khí
Aerial cable	- (tech) cáp treo, cáp trên không
Aerial gain = antenna gain	- (tech) gia lượng dây trời
Aerie	tổ chim làm tít trên cao (của chim săn mồi)
Aerifecation	việc dẫn không khí
Aeriferous	dẫn không khí, chứa không khí
Aeriform	dạng hơi
Aerify	làm hoá ra thể hơi, khí hoá
Aero	phi thuyền, phi cơ
Aero-	- tiền tố có nghĩa "không khí, không gian"
Aero-engine	động cơ máy bay
Aeroballistics	khoa đạn đạo học
Aerobat	phi công nhào lộn trên không
Aerobatic	(nói về máy bay) nhào lộn trên không
Aerobatics	sự nhào lộn trên không (của máy bay)
Aerobe	vi sinh vật ưa khí
Aerobic	đói không khí, thiếu không khí
Aerobics	thể dục nhịp điệu
Aerobiological	xem aerobiology
Aerobiologically	xem aerobiology
Aerocarrier	tàu sân bay
Aeroculture	phương pháp nuôi trồng thực vật không cần đất
Aerocyste	túi khí (tảo)
Aerocyte	tế bào khí
Aerodrome	sân bay
Aerodynamic	khí động lực
Aerodynamical	khí động lực
Aerodyne	máy bay nặng hơn không khí
Aeroembolism	(y học) bệnh khí ép
Aerofoil	cánh máy bay
Aerogram	bức điện rađiô
Aerograph	máy ghi khí tượng
Aerography	môn nghiên cứu không khí và khí quyển
Aerogun	súng gắn trên máy bay
Aerohydroplane	thủy phi cơ
Aerolite	đá trời, thiên thạch
Aerolith	(thiên) thiên thạch
Aerolithology	thiên thạch học
Aesthetic	thẩm mỹ
Affair	chuyện
Affect	có ảnh hưởng đến
Afford	đủ khả năng
Afraid	sợ
African	Châu Phi
African-american	Người Mỹ gốc Phi
After	sau
Afternoon	buổi chiều
Afterward	sau đó
Again	lần nữa
Against	chống lại
Age	tuổi tác
Agency	đại lý
Agenda	chương trình nghị sự
Agent	đặc vụ
Aggression	Hiếu chiến
Aggressive	xâm lược
Ago	trước
Agree	đồng ý
Agreement	thỏa thuận
Agricultural	nông nghiệp
Agriculture	nông nghiệp
Ah	ah
Ahead	phía trước
Aid	viện trợ
Aide	trợ lý
Aids	AIDS (bệnh lây nhiễm qua đường tình dục)
Aim	mục đích
Air	không khí
Aircraft	phi cơ
Airline	hãng hàng không
Airplane	Máy bay
Airport	sân bay
Aisle	lối đi
Alarm	báo thức
Album	album
Alcohol	rượu
Alien	người ngoài hành tinh
Alike	như nhau
Alive	sống sót
All	tất cả các
Allegation	cáo buộc
Alleged	cáo buộc
Allegedly	bị cáo buộc
Alley	hẻm
Alliance	liên minh
Allow	cho phép
Ally	đồng minh
Almost	hầu hết
Alone	một mình
Along	dọc theo
Alongside	bên cạnh
Already	đã
Also	cũng thế
Alter	thay đổi
Alternative	thay thế
Although	mặc dù
Altogether	hoàn toàn
Aluminum	nhôm
Always	luôn luôn
Am	là
Amazing	kinh ngạc
Ambassador	đại sứ
Ambition	tham vọng
Ambitious	đầy tham vọng
Amendment	sửa đổi
American	Người Mỹ
Amid	giữa
Among	trong số
Amount	số lượng
Analysis	phân tích
Analyst	nhà phân tích
Analyze	phân tích
Ancestor	tổ tiên
Ancient	xưa
And	và
And/or	và / hoặc
Angel	Thiên thần
Anger	Sự phẫn nộ
Angle	góc
Angry	bực bội
Animal	thú vật
Ankle	mắt cá
Anniversary	ngày kỷ niệm
Announce	tuyên bố
Announcement	thông báo
Annual	hàng năm
Annually	hàng năm
Anonymous	vô danh
Another	khác
Answer	câu trả lời
Anticipate	đoán trước
Anxiety	sự lo ngại
Anxious	lo lắng
Any	bất kì
Anybody	bất kỳ ai
Anymore	nữa không
Anyone	bất kỳ ai
Anything	bất cứ điều gì
Anyway	dù sao
Anywhere	ở đâu
Apart	xa nhau
Apartment	căn hộ, chung cư
Apologize	xin lỗi
Apology	xin lỗi
Apparent	rõ ràng
Apparently	dường như
Appeal	kháng cáo
Appear	xuất hiện
Appearance	xuất hiện
Apple	táo
Application	ứng dụng
Apply	ứng dụng
Appoint	bổ nhiệm
Appointment	cuộc hẹn
Appreciate	đánh giá
Appreciation	sự đánh giá
Approach	tiếp cận
Appropriate	thích hợp
Approval	sự chấp thuận
Approve	tán thành
Approximately	xấp xỉ
Arab	Ả-rập
Architect	kiến trúc sư
Architecture	kiến trúc
Area	khu vực
Arena	đấu trường
Argue	tranh luận
Argument	tranh luận
Arise	nảy sinh
Arm	cánh tay
Armed	trang bị
Army	quân đội
Around	xung quanh
Arrange	sắp xếp
Arrangement	sắp xếp
Array	mảng
Arrest	bắt giữ
Arrival	sự đến
Arrive	đến nơi
Arrow	mũi tên
Art	nghệ thuật
Article	bài báo
Articulate	khớp nối
Artifact	đồ tạo tác
Artificial	nhân tạo
Artist	họa sĩ
Artistic	nghệ thuật
As	như
Ash	tro
Asian	Châu Á
Aside	qua một bên
Ask	hỏi
Asleep	ngủ
Aspect	khía cạnh
Ass	mông
Assault	tấn công
Assemble	tập hợp
Assembly	hội,, tổ hợp
Assert	khẳng định
Assess	đánh giá
Assessment	thẩm định, lượng định, đánh giá
Asset	tài sản
Assign	chỉ định
Assignment	nhiệm vụ
Assist	hỗ trợ
Assistance	hỗ trợ
Assistant	phụ tá
Associate	liên kết
Associated	liên kết
Association	hiệp hội
Assume	giả định
Assumption	giả thiết
Assure	cam đoan
Astronomer	nhà thiên văn học
At	tại
Athlete	lực sĩ
Athletic	Khỏe mạnh
Atmosphere	không khí
Atop	trên
Attach	đính kèm
Attack	tấn công
Attempt	cố gắng
Attend	tham gia
Attendance	sự tham dự
Attention	chú ý
Attitude	Thái độ
Attorney	luật sư
Attract	thu hút
Attraction	sức hút
Attractive	hấp dẫn
Attribute	thuộc tính
Auction	bán đấu giá
Audience	thính giả
Aunt	cô dì
Author	tác giả
Authority	thẩm quyền
Authorize	cho phép
Auto	Tự động
Automatic	tự động
Automatically	tự động
Automobile	ôtô
Autonomy	tự trị
Availability	khả dụng
Available	có sẵn
Available capacity	dung lượng có sẵn
Available energy	năng lượng khả dụng
Available execution time	thời gian hành xử được
Available machine time	thời gian dùng được máy
Available power	công suất hữu hiệu, công suất khả dụng
Avalanche breakdown	sự suy sụp do dòng điện thác
Avalanche current	dòng điện thác
Avalanche diode	đèn hai cực thác
Avalanche formation	hình thành thác
Avalanche impedance	trở kháng thác
Avalanche injection	phun thác
Avalanche injection laser	bộ kích quang phun thác
Avalanche ionization	ly tử hóa (do hiệu ứng) thác
Avalanche multiplication	nhân thác
Avalanche multiplication factor	hệ số nhân thác
Avalanche noise	nhiễu âm thác
Avalanche photodevice	bộ quang thác
Avalanche photodiode	đèn hai cực quang thác
Avalanche transistor	đèn tinh thể (trăng-xít-to) thác
Avalanche triggering	kích động thác
Avalanche triode	đèn ba cực thác
Avarice	tính hám lợi, tính tham lam
Avaricious	hám lợi, tham lam
Avariciously	tham lam
Avariciousness	tính hám lợi, tính tham lam
Avascular	(sinh học) không mạch
Avast	đứng lại, dừng lại
Avaunt	đi đi
Avenger	người trả thù, người báo thù
Avengingly	xem avenge
Avens	số nhiều avens
Average	Trung bình cộng
Average adjuster	người xét định những thiệt hại trên mặt biển
Average bright	độ chói trung bình
Average calculating time	thời gian tính toán trung bình
Average capacity	dung lượng trung bình
Average delay time	thời gian chậm trễ trung bình
Average density	mật độ trung bình
Average frequency	tần số trung bình
Average total cost	tổng chi phí bình quân
Average value	trị số trung bình
Average variable cost	avc-chi phí khả biến bình quân.
Averaged characteristic	đặc tính trung bình
Averagely	trung bình
Averageness	xem average
Averaging	lấy trung bình (d)
Averaging principle	nguyên lý trung bình
Averaging rectifier	bộ chỉnh lưu trung bình
Averment	sự xác nhận; sự khẳng định, sự quả quyết
Averrable	xem aver
Averruncator	kéo tỉa cành cao su
Averse	chống lại, ghét
Avesta	thánh kinh ba tư giáo
Avestan	tiếng avexta (tiếng iran cổ)
Avian	(thuộc) loài chim
Aviarist	người nuôi chim
Aviary	chuồng chim
Aviate	bay, đi (bằng máy bay, khí cầu)
Aviation service	(tech) ngành hàng không
Aviator	người lái máy bay, phi công
Aviatress	nữ phi công
Aviatrice	nữ phi công
Aviatrix	nữ phi công
Aviculture	nghề nuôi chim
Aviculturist	xem aviculture
Avid	khao khát, thèm khát(tham lam)
Avidly	say sưa, ngấu nghiến
Aviette	(hàng không) máy bay nhỏ, máy bay loại nhẹ
Avifauna	hệ chim (của một vùng, một xứ)
Avifaunal	xem avifauna
Avionic	xem avionics
Avionics	(tech) kỹ thuật điện tử hàng không
Aviso	(hàng hải) tàu thông báo
Avitaminosis	(y học) bệnh thiếu vitamin
Avitaminotic	xem avitaminosis
Avocado	(thực vật học) lê tàu
Avocation	công việc phụ; việc lặt vặt
Avocational	xem avocation
Avocationally	xem avocation
Avocet	(động vật học) chim mỏ cứng
Avogadrós number	(tech) số avôgaddrô
Avoid	tránh
Avoidable	có thể tránh được
Avowal	sự nhận; sự thừa nhận; sự thú nhận
Avowed	đã được công khai thừa nhận; đã được công khai thú nhận
Avowedly	đã được công khai thừa nhận; đã được công khai thú nhận
Avuncular	(thuộc) chú, (thuộc) bác, (thuộc) cậu; như chú, như bác, như cậu
Awacs	hệ thống báo và điều khiển trên không (airborne warning and control system)
Await	chờ đợi
Awaiting	thời gian chờ đợ sửa chữa
Awake	thức tỉnh
Awakener	xem awaken
Awakening	hành vi nhận thức
Award	giải thưởng
Awardable	xem award
Awardee	người được tặng thưởng
Awarder	xem award
Aware	ý thức
Awareness	nhận thức
Awash	vị ngữ trôi nổi trên mặt nước
Away	xa
Away game	(thể dục,thể thao) cuộc đấu ở sân đối phương
Awesomeness	tính đáng kinh sợ; sự làm khiếp sợ; sự làm kinh hoàng
Awestricken	kinh sợ; khiếp sợ; kinh hoàng
Awestruck	kinh sợ; khiếp sợ; kinh hoàng
Awful	kinh khủng
Awfully	tàn khốc, khủng khiếp|- vô cùng, hết sức
Awhile	một lúc, một lát, một chốc
Axeman	người dùng rì
Axial field	(tech) trường hướng trục
Axial lead	(tech) đầu ra theo trục
Axial mode	(tech) kiểu dao động xuyên tâm
Axial mode helix	(tech) đường xoắn ốc kiểu dọc trục
Axial ratio	(tech) tỷ số trục (hình bầu dục)
Axial slot	(tech) khe theo trục
Axial symmetry	(tech) tính đối xứng theo trục
Axiality	xem axial
Axially	xem axial
Axil	(thực vật học) nách lá
Axile	(sinh học) đính trụ; gắn trụ
Axilla	(giải phẫu) nách|- (thực vật học) (như) axil
Axillae	(giải phẫu) nách|- (thực vật học) (như) axil
Axillary	(giải phẫu) (thuộc) nách|- (thực vật học) ở nách lá
Axiology	thuyết giá trị; giá trị học
Axiomatizability	tính tiên đề hoá
Axiomatizable	tiên đề hoá được
Axiomatization	tiên đề hoá
Axipetal	hướng trục, hướng trụ
Axisymmetric(al)	đối xứng theo trục
Axle	(kỹ thuật) trục xe
Axle grease	mỡ tra trục, mỡ tra máy
Axoid	dạng trục
Axoloti	(sinh vật) ấu trùng axoloti
Axon	sợi trục (thần kinh),  axon
Axonometry	(toán học) trục lượng học
Axopetal	(sinh học) hướng trục
Axoplasm	(sinh học) chất sợi trục
Axoplast	hạt sợi trục
Axopodium	(sinh học) chân giả sợi trục
Axosomatic	thuộc thể trục
Axostyle	(sinh học) cuống trục
Ayah	anh-ân vú em; người hầu gái
Ayatollah	thủ lĩnh cao tuổi của hồi giáo ở iran
Aye	luôn luôn; trong mọi trường hợp
Azalea	(thực vật học) cây khô (họ đỗ quyên)
Azilian	(thuộc) thời kỳ azin (thời kỳ chuyển tiếp giữa thời kỳ đồ đá cũ và thời kỹ đồ đá mới)
Azimith	góc cực
Azimuth beam	(tech) góc phương vị
Azimuth coverage	(tech) phạm vi/góc quét phương vị
Azimuth drive	(tech) truyền động phương vị
Azimuth potentiometer	(tech) máy điện thế phương vị, bộ biến trở phương vị
Azimuth rate	(tech) tốc độ thay đổi phương vị
Azimuth resolution	(tech) độ phân giải phương vị
Azimuth selsyn	(tech) máy tự đồng bộ phương vị
Azimuth sweep	(tech) quét phương vị
Azimuthal	(thuộc) góc phương vị
Azimuthal component	(tech) thành phần phương vị
Azimuthally	xem azimuth
Azin	(hoá học) azin
Azoic	vô sinh|- (địa lý,địa chất) không có tàn tích hữu cơ
Azole	(hoá học) nitơ
Azolla	(thực vật học) bèo dâu, bèo hoa dâu
Azonal	(địa lý) phi địa đới
Azotaemia	(y học) hứng tăng urê huyết
Azote	(hoá học) nitơ
Azoth	thủy ngân
Azotobacter	(sinh học) đạm khuẩn
Azotobacterin	phân azotobacterin
Azoturia	(y học) chứng đái nitơ
Aztec	người axtec (ở mêc-xich,  bắc mỹ)
Azurit	(khoáng chất) azurit
Azygous	(sinh vật học) đơn (tĩnh mạch, động mạch)
Azymic	không lên men
Azymous	không men
Babe	(thơ ca) trẻ sơ sinh,
Babel	(kinh thánh) (babel) tháp ba-ben
Babirusa	cũng babirussa,  babiroussa
Baboon	(động vật học) khỉ đầu chó
Baboonery	xem baboon
Baboonish	xem baboon
Babu	số nhiều babus
Baby	đứa bé
Baby buggy	xe đẩy trẻ con
Baby carriage	xe đẩy trẻ con
Baby grand	đàn piano cánh loại nhỏ
Baby talk	tiến bi bô (của trẻ em)
Baby tooth	răng sữa
Babyhood	tuổi thơ
Babyish	trẻ con, như trẻ con
Babyishness	tính trẻ con, tính như trẻ con
Babyism	tính trẻ con, tính như trẻ con
Bacalao	cá tuyết to đầu muối phơi khô
Bacca	số nhiều baccae
Baccalaureate	bằng tú tài
Baccarat	(đánh bài) trò chơi bacara
Baccate	mềm như quả mọng
Bacchae	các nữ tu sĩ của bắc cút (thần rượu nho)
Bacchanal	(thuộc) thần bắc-cút
Bacchanalia	thầy tế thần rượu bắc-cút
Bacchanalian	(số nhiều) buổi tế thần rượu bắc-cút
Bacchant	thầy tế thần rượu bắc-cút
Bacchantic	xem bacchant
Bacchic	(thuộc) thần bắc-cút
Bacchus	(thần thoại,thần học) thần rượu bắc-cút
Bacciferous	(thực vật học) có quả mọng, mang quả mọng
Bacciform	hình quả mọng
Baccivorous	(động vật học) ăn quả mọng
Baccy	(thông tục) thuốc lá
Bachelor	người chưa vợ
Bachelorhood	đời sống độc thân
Bachelorship	(như) bachelorhood
Bacillary	(thuộc) khuẩn que
Bacilli	khuẩn que
Bacilliform	hình que
Bacillus	khuẩn que
Bacitracin	thuốc kháng sinh
Back	trở lại
Back bench	hàng ghế sau (dành cho nghị viên thứ yếu của mỗi đảng có đại diện, ở nghi viện anh)
Back conduction	(tech) dẫn ngược
Back coupling	(tech) ghép ngược
Back dating	(tech) ghi lại ngày trước
Back door	cửa sau, cổng sau (nghĩa đen) & bóng
Back end	(tech) đầu sau, đoạn cuối
Back feed	(tech) cung cấp ngược lại
Back formation	[phương thức tạo] từ tưởng như có nguồn gốc ngược lại
Back lash	(tech) voltage điện áp lưới ngược
Back lash potential	(tech) điện thế lưới ngược
Back number	số (tạp chí...) cũ
Back of	(từ mỹ,nghĩa mỹ) đằng sau
Back out	(tech) hoàn nguyên
Back out of	(tech) lùi ra khỏi, ngược về
Back page	(tech) trang mặt sau
Back panel	(tech) bảng mặt sau (máy điện toán)
Back propagation	(tech) truyền lan ngược
Back reference	(tech) tham khảo ngược
Back resistance	(tech) điện trở ngược
Back scattering	(tech) tán xạ ngược
Back scheduling	(tech) lập thời biểu ngược
Back seat	ghế sau trong xe ôtô
Back slang	lời nói đảo (như ynnep thay cho penny)
Back stroke	(tech) chuyển động lùi
Back voltage	(tech) điện áp ngược
Backache	chứng đau lưng
Backbit	nói vụng, nói xấu sau lưng
Backbite	nói vụng, nói xấu sau lưng
Backbiter	kẻ
Backbiting	sự nói vụng, sự nói xấu sau lưng
Backbitten	nói vụng, nói xấu sau lưng
Backboard	ván hậu (xe bò...)
Backbone	xương sống
Backboned	xem backbone
Backcomb	chải ngược từ đầu đến chân tóc, để tóc có vẻ dầy lên
Backcross	(sinh học) lai ngược (giao phối một con lai với bố hoặc mẹ)
Backdate	coi là có giá trị kể từ một thời điểm nào đó trong quá khứ
Backdive	nhảy cầu xuống nước bằng cách quay lưng về phía nước
Backdrop	tấm màn vẽ căng sau sân khấu
Backelordom	xem bachelor
Backer	người giúp đỡ, người ủng hộ
Backfill	lấp đất lại (đặc biệt sau một cuộc khai quật (khảo cổ học))
Backfire	đốt lửa chặn (cho một đám cháy khỏi lan hết cánh đồng cỏ)
Backgammon	cờ tào cáo
Background	lý lịch
Background information	(tech) thông tin cơ sở, tin tức nguồn cội
Background job	(tech) công việc thứ cấp, công việc bối cảnh
Background mode	(tech) chế độ thứ cấp
Background noise	(tech) tiếng ồn phông, tiến ồn bối cảnh, nhiễu loạn xung quanh
Background printing	(tech) in trong bối cảnh
Background processing	(tech) xử lý trong bối cảnh
Background sound	(tech) âm tạp, âm nền, âm bối cảnh
Backhand	(thể dục,thể thao) cú ve, quả trái
Backhanded	trái, sấp tay
Backhander	cú đánh trái, cái tát trái
Backhouse	(từ mỹ) nhà vệ sinh ở ngoài nhà
Backing	sự giúp đỡ
Backing memory	(tech) bộ nhớ lưu
Backing out	(tech) hồi phục ngược [nb]
Backing storage	(tech) bộ trữ dự phòng
Backing up	(tech) dự phòng
Backing up system	(tech) hệ thống sao trữ dự phòng
Backlash	(tech) khe, khoảng trống
Backless	cắt thấp ở phía lưng (nói về quần áo)
Backlight	(tech) ánh sáng bối cảnh
Backlist	danh mục các sách đang in của nhà xuất bản
Backlog	dự trữ
Backmost	cuối cùng, tít cùng đằng sau
Backpack	cái ba lô đeo trên vai
Backpacker	khách du lịch chỉ có hành lý gọn nhẹ là một chiếc ba lô
Backpacking	xem backpack
Backplane	tấm lưng (một loại board mẹ trong máy tính cá nhân)
Backplane	bảng chính, bảng hệ thống
Backrest	cái dùng để tựa lưng
Backrolling	(tech) quấn ngược
Backroom boys	(thông tục) những người nghiên cứu bí mật
Backscattering	(tech) tán xạ ngược
Backscratcher	cái dùng để gải lưng
Backside	mông đít
Backsight	cảnh gần mắt nhất khi ngắm súng
Backslash	(tech) dấu chéo ngược
Backslide	tái phạm, lại sa ngã
Backslider	kẻ tái phạm
Backsliding	sự tái phạm
Backspace	chuyển cần máy chữ ngược lại một hoặc nhiều khoảng, bằng cách bấm vào một phím đặc biệt dành cho việc này
Backspace (bs)	(tech) lùi một nấc, xóa ngược
Backspace character	(tech) ký tự lùi
Backspace key	(tech) phím lùi
Backspace statement	(tech) câu lệnh lùi
Backstage	ở sau sân khấu, ở hậu trường (nghĩa đen) & (nghĩa bóng)
Backstairs	(số nhiều) cầu thang sau
Backstay	(hàng hải) ((thường) số nhiều) dây néo sau (néo cột buồm)
Backstop technology	(econ) công nghệ chặng cuối
Backstreet	phố hẹp (thường) ở phía sau các ngôi nhà
Backstroke	cú trái
Backstrokeer	xem backstroke
Backswept	nghiêng về phía sau
Backtab	(tech) lùi cột
Backtalk	(thông tục) đối đáp lại
Backtrack	quay về theo lối cũ
Backtracking	(tech) tìm ngược, truy tích nghịch
Backup	(tech) dự phòng
Backup copy	(tech) bản sao dự phòng
Backup device	(tech) thiết bị sao dự phòng
Backup disk	(tech) đĩa sao dự phòng
Backup diskette	(tech) đĩa nhỏ sao dự phòng
Backup file	(tech) tập tin sao dự phòng
Backup media	(tech) môi thể dự phòng
Backveld	cũng backveldt
Backward	về phía sau, giật lùi
Backward bending supply curve of labour	(econ) đường cung lao động cong về phía sau.
Backward equation	(tech) phương trình thức lùi
Backward intergration	(econ) liên hợp thượng nguồn.
Backward linkage	(econ) liên kết thượng nguồn.
Backward pointer	(tech) con trỏ ngược
Backward search	(tech) tìm ngược
Backward signal	(tech) tín hiệu nghịch hướng [nb]
Backward signaling	(tech) báo hiệu đằng sau
Backward substitution	(tech) thay thế lùi [nb]
Backward voltage	(tech) điện áp ngược
Backward wave	(tech) sóng phản hồi
Backwardly	xem backward
Backwardness	tình trạng lạc hậu, tình trạng chậm tiến
Backwards	(như) backward
Backwash	nước xoáy ngược, nước cuộn ngược, nước bị mái chèo đẩy ngược
Backwash effects	(econ) hiệu ứng ngược.
Backwater	chỗ nước đọng ở bờ (sông hay lạch)
Backway	con đường hẻm, con đường vắng
Backwood	(thuộc) rừng xa xôi hẻo lánh
Backwoods	(số nhiều) rừng xa xôi hẻo lánh
Backwoodsman	người sống ở rừng
Backyard	sân sau
Bacon	thịt lưng lợn muối xông khói
Bacteraemia	hiện tượng có vi khuẩn bất thường trong máu
Bacteria	vi khuẩn
Bacterial	(thuộc) vi khuẩn
Bacterially	xem bacterial
Bactericide	thuốc diệt vi khuẩn, thuốc sát trùng
Bacterin	vắc xin chế từ vi khuẩn đã chết hoặc không còn khả năng truyền bệnh
Bacteriocin	thuốc kháng sinh làm bằng vi khuẩn
Bacteriological	(thuộc) vi khuẩn học
Bacteriologist	nhà vi khuẩn học
Bacteriology	khoa nghiên cứu vi khuẩn
Bacteriolysis	sự tiêu vi khuẩn, sự tan vi khuẩn
Bacteriophage	vật ăn vi khuẩn
Bacteriostasis	sự kìm hãm vi khuẩn
Bacteriostat	chất kìm hãm vi khuẩn
Bacteriostatic	kìm hãm vi khuẩn
Bacterium	vi khuẩn
Bacteriuria	tình trạng có vi khuẩn trong nước tiểu
Baculine	bằng roi vọt, bằng đòn vọt
Bad	xấu
Bad debt	món nợ không có khả năng hoàn lại
Bad disk	(tech) đĩa hư
Bad lands	(từ mỹ,nghĩa mỹ) vùng đất đai cằn cỗi
Bad language	lời nói thô tục
Bad money drive out good	(econ) đồng tiền xấu đuổi đồng tiền tốt.
Bad packet	(tech) gói hư
Bad sector	(tech) cung hư
Bad track	(tech) đường hư
Baddish	chẳng hay hớm gì
Bade	sự đặt giá, sự trả giá (trong một cuộc bán đấu giá)
Badge	huy hiệu, phù hiệu
Badge reader	(tech) bộ đọc thẻ nhân viên
Badger	(tiếng địa phương) người bán hàng rong
Badinage	sự đùa cợt, sự đùa bỡn
Badlands	(từ mỹ) vùng đất cằn cỗi, lởm chởm đá
Badly	tệ
Badminton	(thể dục,thể thao) cầu lông
Badness	sự xấu, sự tồi
Baedeker	sổ tay hướng dẫn du lịch
Baffle	sự cản trở, sự trở ngại
Baffler	(kỹ thuật) bộ giảm âm
Baffy	(thể dục,thể thao) gậy đánh gôn
Bafta	viện hàn lâm nghệ thuật phim và truyền hình anh quốc 
Bag	túi
Bagasse	bã mía
Bagatelle	vật không giá trị, vật không đáng giá là bao nhiêu
Bagel	chiếc nhẫn
Bagful	bao (đầy), túi (đầy), 
Baggage	(từ mỹ,nghĩa mỹ) hành lý
Baggage animal	súc vật chở hành lý (trang bị...) của quân đội
Baggage car	(từ mỹ,nghĩa mỹ) toa hành lý
Baggage train	(từ mỹ,nghĩa mỹ) xe lửa chở hành lý
Baggieness	sự rộng lùng thùng, sự phồng ra
Bagginess	sự rộng lùng thùng, sự phồng ra
Bagging	vải may bao, vải may túi
Baggy	rộng lùng thùng, phồng ra (quần...
Bagman	người đi chào hàng
Bagnio	nhà giam, nhà tù (ở phương đông)
Bagpipe	kèn túi (của những người chăn cừu ở ê-ãcốt)
Bagpiper	người thổi kèn túi
Bagpipes	kèn túi (của những người chăn cừu ở ê-ãcốt)
Baguette	đường đắp nhỏ
Bail	(pháp lý) tiền bảo lãnh
Bailable	(pháp lý) có thể cho tạm tự do ở ngoài với điều kiện nộp tiền bảo lãnh
Bailer	gàu tát nước
Bailey	tường ngoài (lâu đài)
Bailiff	quan khâm sai (của vua anh ở một vùng)
Bailiwick	địa hạt (của) quan khâm sai
Baillee	người nhận hàng hoá gửi để bảo quản
Bailment	sự ký gửi hàng hoá
Bailor	người ký gửi hàng hoá
Bailout	(kinh tế) sự cứu giúp ra khỏi những khó khăn về tài chính
Bailsman	người đứng ra bảo lãnh (cho ai), người nộp tiền bảo lãnh (cho ai)
Bairn	(ê-cốt) đứa bé
Baiting place	quán trọ dọc đường
Baize	vải len tuyết dài (để bọc bàn ghế)
Bake	nướng, hấp hoặc hầm
Bakehouse	lò bánh mì
Bakelite	bakêlit nhựa tổng hợp
Bakelized	(tech) được tẩm bakêlit (nhựa)
Baker	người làm bánh mì
Bakery	lò bánh mì
Bakestone	cái lót bánh mì (trong lò)
Baking	sự nướng (bánh...)
Baksheesh	(ở vùng trung đông) tiền làm quà hoặc để giúp người nghèo khó
Balaam	người đoán láo
Balaclava	loại mũ khít đầu và cổ, chỉ để hở mặt
Balalaika	(âm nhạc) đàn balalaica
Balance	cân đối
Balance control	(tech) điều chỉnh cân bằng
Balance of payment	(econ) cán cân thanh toán.
Balance of trade	(econ) cán cân thương mại.
Balance principle	(econ) nguyên lý cân đối.
Balance sheet	(econ) bảng cân đối tài sản.
Balanced	cân bằng
Balanced (gdp)	(econ) (gdp) được cân đối.
Balanced load	(tech) tải cân bằng, tải đối xứng
Balanced state	(tech) trạng thái cân bằng
Balancer	con lắc
Balancing	(tech) làm cân bằng
Balancing weight	(tech) trọng lượng cân bằng, đối trọng
Balanitis	(y học) chứng viêm quy đầu
Balante	số nhiều balantes
Balas	(khoáng chất) xpinen đỏ
Balata	balata (nhựa lấy ở cây dùng làm chất cáh điện)
Balayage	sự quyết
Balboa	đồng banboa (tiền pa-na-ma)
Balbriggan	vải bông dùng may quần áo lót hoặc quần áo dệt kim
Bald	hói (đầu)
Bald cypress	(thực vật học) cây bụt mọc
Bald eagle	đại bàng trắng tượng trưng cho nước mỹ
Baldachin	màn treo, trướng (trên bàn thờ)
Baldaquin	màn treo, trướng (trên bàn thờ)
Balderdash	lời nói vô nghĩa không ra đầu vào đâu
Baldicoot	(động vật học) chim sâm cầm
Baldie	(thông tục) người hói đầu
Balding	bắt đầu hói
Baldly	không màu mè, không che đậy
Baldness	tình trạng hói đầu
Baldric	dây gươm chéo qua vai
Bale	kiện (hàng...)
Baleen	tấm sừng hàm (ở cá voi)
Baleful	(thơ ca) tai hoạ, xấu, rủi, không may, gở
Balefully	độc địa, tai hại
Balefulness	xem baleful
Baler	xem bale
Balk	vật chướng ngại
Balkanization	sự phân chia đất nước thành nhiều vùng thù địch lẫn nhau (để dễ cai trị)
Balkanize	phân chia (một đất nước) thành nhiều vùng thù địch lẫn nhau (để dễ cai trị)
Balker	xem balk
Balky	bướng bỉnh (động vật)
Ball	trái bóng
Ball and socket	(kỹ thuật) bản lề hình cầu
Ball game	bất cứ trò chơi nào dùng đến bóng
Ball point mouse	(tech) con chuột điểm cầu
Ball printer	(tech) máy in trái cầu
Ballad	khúc balat, bài ca balat
Ballade	thơ balat
Balladic	xem ballad
Ballast	bì, đồ dằn (vật nặng để giữ cho tàu, thuyền thăng bằng khi không có hàng)
Ballast resistor	(tech) cái điện trở ổn dòng
Ballastron	(tech) barête (ống ổn dòng)
Ballboy	trẻ con nhặt bóng cho người chơi quần vợt
Ballcock	phao dùng để điều chỉnh mực nước trong bể chứa
Ballerina	nữ diễn viên ba lê, nữ diễn viên kịch múa
Ballet	ba lê, kịch múa
Balletomane	người nghiện balê
Balletomania	sự nghiện balê
Ballgirl	trẻ con nhặt bóng cho người chơi quần vợt
Ballista	số nhiều ballistae
Ballistic	(quân sự) (thuộc) đạn đạo học, (thuộc) khoa đường đạn
Ballistic method	(tech) phương pháp đạn đạo
Ballistic missile	(quân sự) tên lừa đảo theo đường đạn
Ballistician	(quân sự) chuyên gia đường đạn
Ballistics	(quân sự) đạn đạo học, khoa đường đạn
Ballistocardiogram	kết quả do tâm thân động ký ghi
Ballitocardiography	khoa tâm thân động ký
Ballocks	<snh> tinh hoàn
Balloon	quả bóng bay
Balloon antenna	(tech) ăngten bong bóng, ăngten khí cầu
Balloon barrage	hàng rào bóng phòng không
Balloon tire	lớp ba lông (ôtô...)
Balloon vine	(thực vật học) dây tấm phông
Ballooner	người cưỡi khí cầu
Balloonist	người cưỡi khí cầu
Ballot	phiếu
Balloter	xem ballot
Ballpark	sân chơi bóng chày
Ballpoint	bút bi
Ballroom	phòng khiêu vũ
Ballroom dance	diệu vũ phòng nhẩy
Ballroom dancing	một kiểu khiêu vũ theo những nhịp điệu quy ước
Bally	(từ lóng) khỉ gió, chết tiệt (diễn tả sự bực mình hoặc thích thú)
Ballyhoo	(từ mỹ,nghĩa mỹ) sự quảng cáo rùm beng
Ballyrag	(từ lóng) chơi xỏ
Balm	nhựa thơm, bôm
Balmily	thơm, thơm ngát
Balminess	sự thơm, sự thơm ngát
Balmy	thơm, thơm ngát
Balneology	(y học) khoa tẩm ngâm, thuỷ lý học
Baloney	chuyện vô lý, chuyện vớ vẩn
Balsa	loại gỗ nhẹ dùng làm hình mẫu, bè
Balsam	nhựa, thơm, bôm
Balsamic	có chất nhựa thơm
Balsaminaceous	(thực vật học) (thuộc) họ bóng nước
Baltic	thuộc biển ban-tích
Balun	(tech) bộ biến thế cân bằng (từ vào đối xứng ra không đối xứng)
Baluster	lan can
Balustrade	hàng lan can, hàng chấn song bao lơn
Bam	(từ cổ,nghĩa cổ),  (từ lóng) sự lừa bịp, sự đánh lừa
Bambino	số nhiều bambinos,  bambini
Bamboo	cây tre
Bamboozle	(từ lóng) bịp, lừa bịp
Bamboozlement	(từ lóng) sự bịp, sự lừa bịp
Bamboozler	(từ lóng) kẻ bịp, kẻ lừa bịp
Bameal	thuộc việc tắm rửa
Ban	lệnh cấm
Banal	thường, tầm thường
Banality	tính chất tầm thường
Banalize	xem banal
Banally	xem banal
Banana	trái chuối
Banana oil	dầu chuối
Banana plug	(tech) phích chuối
Band	ban nhạc
Band filter	(tech) bộ lọc dải
Band printer	(tech) máy in băng
Band selector	(tech) bộ chọn dải sóng
Band separator	(tech) bộ phân chia dải
Band switch	(tech) cái chuyển băng
Band theory	(tech) lý thuyết dải năng lượng
Bandage	băng (để băng vết thương, bịt mắt...)|*  ngoại động từ
Bandager	xem bandage
Bandaid	một loại cao dán
Bandana	khăn rằn, khăn tay lớn in hoa sặc sỡ
Bandanna	khăn rằn, khăn tay lớn in hoa sặc sỡ
Bandbox	hộp bìa cứng
Bandeau	dải buộc tóc (phụ nữ)
Bandeaux	dải buộc tóc (phụ nữ)
Banded	đầu thắt giải buộc
Banderilla	cái lao (dùng trong cuộc đấu bò rừng)
Banderillero	số nhiều banderilleros
Banderol	băng biểu ngữ
Banderole	băng biểu ngữ
Bandfish	(động vật) cá giao đỏ (nhật)
Bandicoot	(động vật học) chuột gộc (ân-độ)
Bandit	kẻ cướp
Banditry	nghề ăn cướp, trò ăn cướp
Banditti	kẻ cướp
Bandleader	ngưởi chỉ huy dàn nhạc nhỏ, thường chơi nhạc nhẹ
Bandmaster	nhạc trưởng, người chỉ huy dàn nhạc
Bandog	chó bị xích
Bandoleer	đeo súng (có ổ gài đạn)
Bandolier	đeo súng (có ổ gài đạn)
Bandoline	gôm chải tóc
Bandsman	nhạc sĩ dàn nhạc
Bandstand	bục dàn nhạc
Bandwagon	xe chở dàn nhạc đi diễu hành
Bane	nguyên nhân suy sụp
Baneberry	loại cây có mùi thum thủm (họ cây mao lương hoa vàng)
Baneful	tai hại, xấu
Banefully	tai hại, xấu xa
Banefulness	tính chất tai hại, tính chất xấu
Bang	tóc cắt ngang trán
Banger	xúc xích
Bangle	vòng (đeo cổ tay, cổ chân)
Bangled	có đeo vòng (cổ tay, cổ chân)
Bangy	(từ mỹ,nghĩa mỹ),  (thông tục) (như) bang-up
Banian	nhà buôn người ân
Banian day	(hàng hải) ngày ăn không có thịt
Banish	đày đi, trục xuất
Banisher	xem banish
Banishment	sự đày, sự trục xuất
Banister	lan can
Banjo	(âm nhạc) đàn banjô
Banjoist	người chơi đàn banjô
Bank	ngân hàng
Bank account	tài khoản ngân hàng
Bank advance	(econ) khoản vay ngân hàng.
Bank bill	(econ) hối phiếu ngân hàng.
Bankable	có thể gửi ở ngân hàng
Banker	chủ ngân hàng
Banking	ngân hàng
Banking system	(tech) hệ thống ngân hàng
Banknote	giấy bạc
Bankroll	(từ mỹ) nguồn cung cấp tiền
Bankrupt	người vỡ nợ, người phá sản
Bankruptcy	sự vỡ nợ, sự phá sản
Bankruptive	xem bankrupt
Banks' cash	tỷ số giữa tiền mặt và tiền gửi của ngân hàng.
Banksman	cai mỏ ở tầng lộ thiên
Banner	ngọn cờ
Banner headline	(từ mỹ,nghĩa mỹ) đầu đề chữ lớn suốt mặt trang báo
Banner page	(tech) trang tiêu đề
Banneret	(thường) viết hoa hiệp sĩ được trao nhiệm vụ dẫn quân xung trận dưới lá cờ của mình
Bannock	bánh mì không men
Banns	sự công bố hôn nhân ở nhà thờ
Banqueter	người dự tiệc lớn
Banquette	(quân sự) chỗ đứng bắn (trong thành luỹ)
Banshee	(thần thoại,thần học) (ê-cốt) nữ thần báo tử
Bantam	gà bantam
Bantam tube	(tech) đèn tí hon
Bantamweight	võ sĩ hạng gà (nặng từ 51 đến 53, 5 kg)
Banter	sự nói đùa, sự giễu cợt
Banterer	xem banter
Bantering	đùa bỡn
Banteringly	đùa, giễu cợt
Banting	(y học) phép chữa kiêng mỡ đường (để chữa bệnh béo phì)
Bantling	đứa trẻ, đứa bé, trẻ con
Bantu	nhóm các dân tộc da đen có liên quan nhau ở trung phi và nam phi|* tính từ
Banyan	nhà buôn người ân
Banzai	thán từ muôn năm!
Baobab	(thực vật học) cây baobap
Baobap	cây bao-báp
Bap	(ê-cốt) ổ bánh nhỏ
Baptise	(tôn giáo) rửa tội
Baptism	(tôn giáo) lễ rửa tội
Baptismal	(tôn giáo) (thuộc) lễ rửa tội
Baptismally	xem baptism
Baptist	(tôn giáo) người làm lễ rửa tội
Baptistery	(tôn giáo) nơi rửa tội (ở nhà thờ)
Baptistry	(tôn giáo) nơi rửa tội (ở nhà thờ)
Baptize	(tôn giáo) rửa tội
Baptizer	xem baptize
Bar	quán ba
Bar billiards	trò chơi trong nhà như trò chơi bida, nhằm đánh những quả tròn vào các lỗ trên bàn
Bar chart	(tech) biểu đồ thanh, biểu đồ dải
Bar code	(tech) mã thanh, mã dải
Bar graph	(tech) đồ thị thanh, đồ thị dải
Bar mitzvah	con trai do thái đến tuổi 13, đảm đương những trách nhiệm tôn giáo như người lớn
Barb	(động vật học) ngựa bác
Barbarian	dã man, man rợ
Barbarianism	xem barbarian
Barbaric	dã man, man rợ
Barbarically	man rợ, dã man
Barbarise	làm cho trở thành dã man (một dân tộc)
Barbarism	tình trạng dã man, tình trạng man rợ
Barbarity	tính chất dã man
Barbarization	xem barbarize
Barbarize	làm cho trở thành dã man (một dân tộc)
Barbarous	dã man, man rợ
Barbarously	dã man, man rợ
Barbarousness	sự dã man, sự man rợ
Barbate	(sinh vật học) có râu
Barbecue	lợn (bò, cừu) nướng (quay) cả con
Barbed	có ngạnh
Barbedness	xem barbed
Barbel	(động vật học) cá râu (loài cá to thuộc họ chép, ở châu âu)
Barbell	thanh tạ
Barber	thợ cạo, thợ cắt tóc
Barberry	(thực vật học) giống cây hoàng liên gai
Barbery	(thực vật học) giống cây hoàng liên gai
Barbet	(động vật học) cu rốc (chim)
Barbette	bệ pháo (trong pháo đài)
Barbican	thành ngoài, luỹ ngoài (của một toà lâu đài, một thành phố...)
Barbiturate	một loại thuốc an thần
Barbituric	(hoá học) bacbituric
Barbola	sự trang trí những vật nhỏ bằng cách gắn hoa, quả tượng trưng lên
Barbule	tơ lông (chim)
Barbwire	(từ mỹ) dây thép gai
Barcarole	bài hát đò đưa (của những người chèo thuyền thành vơ-ni-dơ)
Barcarolle	bài hát đò đưa (của những người chèo thuyền thành vơ-ni-dơ)
Barchan	đụn cát bị gió thổi thành hình lưỡi liềm
Barcode	mã vạch, sọc mã số
Bard	(thơ ca) thi sĩ, nhà thơ
Bardic	xem bard
Bardolatry	sự tôn sùng xếch-xpia
Bare	trần
Bare board	(tech) bảng trần (chưa gắn linh kiện)
Bare bones	cái dơn giản nhất hoặc quan trọng nhất của một vấn đề
Bare cable	(tech) cáp trần
Bare conductor	(tech) dây dẫn trần
Bareback	không có yên (ngựa)
Barebacked	ở trần
Barefaced	mày râu nhẵn nhụi
Barefacedly	xem barefaced
Barefacedness	xem barefaced
Barefoot	chân không
Barefooted	chân không
Barege	vải nhung
Barehanded	tay không (không có đeo găng)
Bareheaded	để đầu trần
Bareheadedness	xem bareheaded
Barelegged	để chân trần
Bareleggedness	xem barelegged
Barely	vừa đủ
Bareness	sự trần trụi, sự trần truồng, sự trơ trụi
Baresark	không có áo giáp
Barfly	(từ mỹ,nghĩa mỹ),  (từ lóng) người hay la cà ở các quán rượu
Bargain	sự mặc cả, sự thoả thuận mua bán
Bargain counter	quầy hàng hạ giá trong một cửa hàng
Bargain hunter	người chuyên săn lùng hàng hạ giá để mua
Bargainer	người mặc cả
Bargaining	sự mặc cả, sự thương lượng mua bán
Bargaining tariff	(econ) thuế quan mặc cả
Bargaining unit	(econ) đơn vị thương lượng
Barge	sà lan
Bargee	người coi sà lan
Bargeman	người coi sà lan
Bargraph	đồ thị dải
Bariated cathode	(tech) âm cực phủ bari
Baric	xem barium
Barie	thanh, thỏi
Barite	(hoá học) barit
Baritone	(âm nhạc) giọng nam trung
Barium	(hoá học) bari
Barium meal	chất cản tia x quang
Bark	tiếng sủa
Barkeeper	(từ mỹ,nghĩa mỹ) chủ quán rượu
Barker	chó sủa
Barkery	nhà máy thuộc da
Barking	tiếng sủa
Barking iron	(từ lóng) súng lục
Barky	có vỏ
Barley	lúa mạch
Barleycorn	hạt lúa mạch
Barm	men (rượu)
Barmaid	cô gái phục vụ ở quán rượu
Barman	người phục vụ ở quán rượu
Barmecidal	đầy đủ
Barmy	có men, lên men
Barn	chuồng trại
Barn dance	điệu nhảy truyền thống của nông thôn
Barnacle goose	(động vật học) ngỗng trời branta
Barney	cãi cọ
Barnstorm	đi biểu diễn lang thang
Barnstormer	diễn viên xoàng
Barnstorming	sự đi biểu diễn lang thang
Barnyard	sân nuôi gà vịt ở quanh nhà kho
Barogram	(vật lý) biểu đồ khí áp
Barograph	(vật lý) máy ghi khí áp
Barographic	xem barograph
Barometer	(vật lý) phong vũ biểu, cái đo khí áp
Barometric	(vật lý) (thuộc) khí áp
Barometric price leadership	(econ) sự chủ đạo theo kế áp giá cả.
Barometrical	(vật lý) (thuộc) khí áp
Barometrically	xem barometer
Barometry	xem barometer
Baron	nam tước
Baronage	hàng nam tước
Baroness	nam tước phu nhân
Baronet	tòng nam tước
Baronetage	tước huân
Baronetcy	tước tòng nam
Barong	dao to bản dùng ở philippin
Baronial	(thuộc) nam tước
Barony	lãnh địa của nam tước
Baroque	kỳ dị, lố bịch
Baroquely	xem baroque
Baroscope	(vật lý) cái nghiệm áp
Barouche	xe ngựa bốn bánh
Barque	thuyền ba buồm
Barrack	trại lính, doanh trại
Barracker	xem barrack
Barracking	sự phản đối của khán giả bằng cách la ó
Barracks	trại lính
Barracoon	trại nhốt nô lệ, trại giam tù khổ sai
Barracuda	(động vật học) cá nhồng
Barrage	đập nước
Barrator	người hay gây sự, người hay sinh sự, người hay kiện cáo lôi thôi
Barratrous	xem barratry
Barratrously	xem barratry
Barratry	tính hay gây sự, tính hay sinh sự, tính hay kiện cáo lôi thôi
Barre	xà ngang để cho các vũ nữ balê tập
Barred	có vạch kẻ dọc
Barrel	thùng
Barrel antenna	(tech) ăngten hình trống, ăngten (cosec) bình phương
Barrel organ	(nhạc) đàn hộp (có tay quay)
Barrelled	shaped)
Barren	cằn cỗi (đất)
Barrenly	xem barren
Barrenness	sự cằn cỗi
Barretter	(tech) bộ điện trở ổn dòng
Barricade	vật chướng ngại (để chặn, phòng thủ)
Barricader	xem barricade
Barrier	rào chắn
Barriers to entry	(econ) rào cản nhập ngành
Barring	trừ, trừ ra
Barrister	luật sư
Barristers	law
Barroom	xe cút kít ((cũng) wheel barroom)
Barrow	gò, đống (chỉ dùng với tên địa điểm)
Bartender	người phục vụ ở quầy rượu
Barter	(econ) hàng đổi hàng
Barterer	xem barter
Bartizan	chòi canh có lỗ châu mai
Bartizaned	xem bartizan
Barycentric coordinate	(tech) tọa dộ trọng tâm [nb]
Baryta	(hoá học) barit
Basal	cơ bản, cơ sở
Basally	xem basal
Basalt	(khoáng chất) bazan
Basaltic	(thuộc) bazan
Basan	da cừu thuộc bằng vỏ cây
Bascule	máy nâng (cầu cất)
Base	căn cứ
Base frequency	(vật lý) tần số cơ bản
Base hit	cú đánh làm cho người đánh chạm được góc thứ nhất (bóng chày)
Base level	(tech) mức cơ bản
Base line	(tech) đường đáy
Base material	(tech) nguyên liệu
Base metal	kim loại thường (không phải kim loại quí như sắt chì...)
Baseball	bóng chày
Baseballer	(thể dục,thể thao) cầu thủ bóng chày
Baseband	(tech) dải gốc
Baseboard	ván gỗ ghép chân tường
Baseborn	xuất thân tầm thường, xuất thân tầng lớp dưới
Baseless	không có cơ sở, không có căn cứ
Baseless tube	(tech) đèn không đế
Baseline	(tech) đường gốc, đường không
Basely	hèn hạ, đê tiện
Basement	tầng hầm
Baseness	tính hèn hạ, tính đê tiện
Basenji	giống chó nhỏ châu phi đuôi xoắn, ít khi sủa
Bases	nền tảng, cơ sở
Bash	cú đánh mạnh
Bashaw	pasa, tổng trấn (thổ nhĩ kỳ)
Basher	xem bash
Bashful	rụt rè, bẽn lẽn, e lệ
Bashfully	rụt rè, e thẹn
Bashfulness	sự rụt rè, sự bẽn lẽn, sự e lệ
Basic	căn bản
Basic access	(tech) truy cập cơ bản
Basic activities	(econ) các hoạt động cơ bản
Basic address	(tech) địa chỉ cơ bản
Basic attribute set	(tech) tập hợp thuộc tính cơ bản
Basic outcome	(econ) kết cục, kết quả cơ sở.
Basic wage rates	(econ) mức tiền công cơ bản
Basica	một trình thông dịch dùng cho ngôn ngữ lập trình microsoft basic
Basically	về cơ bản
Basicity	(hoá học) tính bazơ
Basidia	(thực vật học) đảm của nấm
Basidial	xem basidium
Basidiomycetes	(thực vật học) nấm đảm
Basidiospore	bào tử đảm
Basidium	(thực vật học) đảm của nấm
Basil	(thực vật học) cây húng quế, cây rau é ((cũng) sweet basil)
Basilar	ở đáy, ở nền
Basilary	ở đáy, ở nền
Basilic	(giải phẫu) basilic vein tĩnh mạch nền trong cánh tay
Basilica	(từ cổ,nghĩa cổ) la-mã hoàng cung
Basilican	xem basilica
Basilisk	(thần thoại,thần học) rắn thần
Basin	cái chậu
Basinal	xem basin
Basinet	mũ bằng thép nhẹ đầu nhọn thời trung cổ
Basinful	khối lượng một cái chậu chứa đựng
Basipetal	(lá và hoa) hướng gốc (phát triển từ đỉnh xuống dưới)
Basis	nền tảng
Basis function	(tech) hàm số gốc
Basis matrix	(tech) ma trận gốc
Bask	phơi nắng, tắm nắng
Basket	cái rổ
Basket case	bệnh nhân bị cưa cụt tất cả chân tay
Basket coil	cuộn dây hình rổ
Basket dinner	bữa ăn trong cuộc đi chơi cắm trại ngoài trời
Basket lunch	bữa ăn trong cuộc đi chơi cắm trại ngoài trời
Basket picnic	cuộc đi chơi cắm trại ngoài trời
Basketball	bóng rổ
Basketful	rổ (đầy), giỏ (đầy), thùng (đầy)
Basketwork	nghề đan rổ rá
Basque	tộc người baxcơ (ở miền tây pirênê,  đông bắc tây ban nha,  tây nam pháp)
Bass	(động vật học) cá pecca
Bass boost	(tech) tăng (âm) trầm
Basset	chó baxet (một giống chó lùn)
Bassinet	nôi có mui bằng mây đan
Bassinette	nôi có mui bằng mây đan
Basso	(âm nhạc) giọng nam trầm
Bassoon	(âm nhạc) kèn fagôt
Bassoonist	xem bassoon
Bast	(thực vật học) libe
Bastadry	hành vi độc ác
Bastard	hoang (đẻ hoang)
Bastard file	dũa cỡ vừa
Bastard slip	(thực vật học) chồi rễ
Bastardisation	sự pha tạp, sự lai căng
Bastardise	tuyên bố là con hoang
Bastardization	sự pha tạp, sự lai căng
Bastardize	tuyên bố là con hoang
Bastardly	xem bastard
Bastardy	tính chất con đẻ hoang
Baste	phết mỡ lên (thịt quay)
Baster	xem baste
Bastille	nhà tù, ngục
Bastinado	trận đòn vào lòng bàn chân
Bastion	pháo đài, thành luỹ
Bastioned	xem bastion
Bat	gậy
Batata	khoai lang
Batch	mẻ (bánh)
Batch access	truy cập theo lô
Batch command	lệnh theo lô
Batch file	tập tin theo lô
Batch job	công việc theo lô
Batch mode	chế độ theo lô
Batch operation	vận hành theo lô
Batch processing	xử lý theo lô
Batching	định lô
Bate	bớt, giảm bớt, trừ bớt
Bateau	số nhiều bateaux
Bated	tính từ
Batfowl	bắt chim bằng đèn sáng (làm cho chúng quáng ánh đèn)
Bath	bồn tắm
Bath chair	ghế lăn, xe lăn (cho người tàn tật)
Bath mat	tấm thảm hút nước ở buồng tắm
Bathe	sự tắm (ở hồ, sông, biển, bể bơi)
Bather	người tắm (ở hồ, sông, biển, hồ...)
Bathetic	tầm thường, xuống cấp
Bathing	sự tắm rửa
Bathing season	mùa tắm biển
Bathometer	máy đo sâu
Bathos	chỗ sâu, vực thẳm
Bathrobe	thành ngữ bath
Bathroom	phòng tắm
Bathyal	liên quan tới độ sâu của biển (khoảng 200 đến 2000 mét)
Bathymetric	xem bathymetry
Bathymetrically	xem bathymetry
Bathymetry	phép đo sâu (của biển)
Bathyscaphe	cũng bathyscaph
Bathysphere	quả cầu rắn chắc có thể đặt xuống biển sâu để quan sát sự sống dưới biển, tiềm thủy cầu
Batik	(nghành dệt) lối in hoa batic (bằng cách bôi sáp lên những chỗ không muốn nhuộm màu)
Bating	trừ, trừ ra
Batiste	phin nõn
Batman	người phục vụ, cần vụ (của sĩ quan cấp cao)
Baton	dùi cui (cảnh sát)
Batrachian	(thuộc) ếch nhái
Bats	điên
Batsman	(thể dục,thể thao) vận động viên bóng chày, vận động viên crickê
Battalion	(quân sự) tiểu đoàn
Batten	ván lót (tường, sàn, trần)
Batter	(thể dục,thể thao) vận động viên bóng chày, vận động viên crickê|*  danh từ
Battered	méo mó, mòn vẹt
Battery	ắc quy
Battiness	xem batty
Batting	(thể dục,thể thao) sự đánh (bóng...) bằng gậy
Battle	chiến đấu
Battle cruiser	tàu chiến  tuần dương
Battle cry	giống như war cry
Battlecraft	tài nghệ chiến đấu
Battledore	(thể dục,thể thao) vợt chơi cầu lông
Battledress	quân phục
Battlefield	chiến trường
Battleground	(như) battlefield
Battlement	((thường) số nhiều) tường có lỗ châu mai
Battlements	tường có lỗ châu mai
Battler	xem battle
Battleship	(hàng hải) tàu chiến lớn
Battue	(săn bắn) sự săn đuổi
Batty	(từ lóng) điên dại, gàn
Batwing antenna	(tech) ăngten cánh dơi
Batwing dipole	(tech) ngẫu cực cánh dơi
Bauble	đồ trang sức loè loẹt rẻ tiền
Baud	(tech) bốt (số phần tử mã trong một giây)
Baud rate	(tech) tốc độ bốt, tốc độ truyền
Baulk	vật chướng ngại
Bauxite	(khoáng chất) bauxit
Bauxitic	xem bauxite
Bawbee	(ê-cốt) đồng trinh
Bawd	trùm nhà thổ
Bawdily	tục tựu
Bawdiness	sự thô tục, sự tục tựu
Bawdy	tục tĩu dâm ô
Bawdyhouse	nhà thổ
Bawl	tiếng nói oang oang
Bawler	xem bawl
Bay	bay
Bay leaf	lá nguyệt quế
Bay window	cửa sổ lồi (ra ngoài)
Bayadère	vũ nữ (ân nom gứ
Bayadre	vũ nữ (ân độ)
Bayberry	(thực vật) cây thanh mai
Bayesian techniques	(econ) kỹ thuật bayes.
Bayonet	lưỡi lê
Bayonet base	(tech) đui ngạnh
Bayonet socket	(tech) đui ngạnh
Bayou	nhánh sông
Bazaar	chợ (ở phương đông)
Bazan	da cừu thuộc bằng vỏ cây
Bazar	chợ (ở phương đông)
Bazooka	(quân sự) súng bazôca
Bcd	mã 2-10, mã bcd
Bcd	số thập phân biên mã nhị phân
Be	thì,là, bị, ở,được
Beach	bờ biển
Beach buggy	xe nhỏ có động cơ dùng để đua ở các bờ biển, đất hoang
Beach umbrella	dù che ở bãi biển
Beachhead	vị trí đổ bộ, đầu cầu đổ bộ
Beachwear	quần áo mặc để tắm biển
Beacon	đèn hiệu
Beacon fire	lửa hiệu
Beacon light	lửa hiệu
Bead	hạt hột (của chuỗi hạt)
Bead capacitor	(tech) bộ điện dung hình chuỗi
Bead transistor	(tech) đèn tinh thể hạt
Beading	sự xâu thành chuỗi
Beadle	(tôn giáo) thầy tử tế
Beadledom	thói hình thức ngu xuẩn, thói quan liêu giấy tờ
Beady	nhỏ như hạt, tròn nhỏ và sáng
Beagle	chó săn thỏ
Beagling	môn săn thỏ bằng chó
Beak	mỏ (chim)
Beaked	có mỏ
Beaker	cái cốc vại, cái chén tống
Beam	chùm tia
Beam angle	(tech) góc chỉ hướng, góc chùm
Beamwidth	(tech) độ rộng chùm
Beamy	to, rộng (tàu thuỷ)
Bean	hạt đậu
Bean pole	cọc cho đậu leo
Beanery	(từ mỹ,nghĩa mỹ),  (thông tục) quán ăn (rẻ tiền)
Beano	(từ lóng) (như) bean-feast
Bear	chịu
Bear's cub	gấu con
Bear's foot	cây trị điên
Bear's whelp	gấu con
Bearable	có thể chịu đựng được
Beard	râu
Bearded	có râu
Beardless	không có râu
Beardlessness	tình trạng không râu
Bearer	người đem, người mang, người cầm (thư, điện...)
Bearer bonds	(econ) trái khoán không ghi tên.
Bearer capability	(tech) khả năng bộ truyền tin
Bearer service	(tech) dịch vụ bộ truyền tin
Beargarden	cảnh ồn ào hỗn độn
Bearing	sự mang
Bearish	xấu tính, hay gắt, hay cau có
Bearishness	tính hay gắt, tính hay cau
Bearleader	người dạy gấu
Bears	(econ) người đầu cơ giá xuống.
Bearskin	da gấu
Beast	quái thú
Beastliness	sự tham ăn, tham uống
Beastly	như súc vật, thô lỗ, cục cằn
Beat	tiết tấu
Beat amplitude	(tech) biên độ phách
Beaten	đập, nện (nền đường...)
Beater	người đánh, người đập
Beatific	ban phúc lành
Beatification	sự ban phúc lành
Beatify	ban phúc lành
Beating	sự đánh, sự đập, sự nện
Beating oscillator	(tech) bộ dao động phách
Beatitude	phúc lớn
Beatnik	(từ mỹ,nghĩa mỹ) thanh niên lập dị chống lại những qui ước xã hội, híp pi
Beau	người đàn ông ăn diện
Beau ideal	cái đẹp lý tưởng
Beaufort scale	thang đo tốc độ gió từ 0 (tựnh lặng) đến 12 (bão)
Beaujolais	rượu vang nhẹ ở vùng beaujolais của pháp
Beauteous	(thơ ca) đẹp
Beautician	(từ mỹ,nghĩa mỹ) người chủ mỹ viện
Beautifier	người làm đẹp, người tô điểm
Beautiful	đẹp
Beautifully	tốt đẹp, đáng hài lòng
Beautify	làm đẹp, tô điểm
Beauty	sắc đẹp, vẻ đẹp
Beauty contest	cuộc thi sắc đẹp
Beauty queen	hoa hậu
Beauty salon	thẩm mỹ viện
Beauty spot	cảnh đẹp, thắng cảnh
Beaux	người đàn ông ăn diện
Beaver	(động vật học) con hải ly
Beavertail antenna	(tech) ăngten hình đuôi hải ly, ăngten (sóng) bình diện
Bebop	(từ mỹ,nghĩa mỹ) nhạc bibôp (một loại nhạc ja)
Becalm	làm yên, làm yên lặng, làm cho êm, làm cho dịu
Became	trở nên, trở thành
Because	bởi vì
Bechamel	nước xốt bêsamen
Beck	suối (ở núi)
Beckon	vẫy tay ra hiệu, gật đầu ra hiệu
Becloud	che mây
Become	trở nên
Becoming	vừa, hợp, thích hợp, xứng
Becquerel	đơn vị đo phóng xạ trong hệ thống đo lường quốc tế
Bed	Giường
Bedable	làm bẩn, vấy bẩn
Bedaub	vấy sơn, vấy bẩn, làm lem luốc
Bedder	người đánh luống
Bedding	bộ đồ giường (chăn, gối, nệm, khăn trải giường)
Bedeck	trang hoàng, trang trí
Bedel	người phụ trách tiếp tân
Bedevil	hành hạ, làm điêu đứng,áo ngủ (của nữ)
Bedevilment	sự bị thu mất hồn vía, sự bị ma trêu quỷ ám
Bedew	làm ướt đẫm
Bedfellow	bạn cùng giường
Bedgown	áo ngủ của nữ
Bedim	làm cho loà, làm cho mờ
Bedizen	tô son điểm phấn loè loẹt, cho ăn mặc loè loẹt
Bedlam	bệnh viện tinh thần, nhà thương điên
Bedlamite	người điên|*  tính từ
Bedouin	người a-rập du cư
Bedpan	bô (đi ỉa, đi đái của người ốm)
Bedpost	cột giường
Bedrabbled	vấy bùn
Bedraggle	kéo lê làm bẩn (áo, quần...)
Bedrail	thành giường
Bedridden	nằm liệt giường (vì ốm hay tàn tật)
Bedroll	giường xếp
Bedroom	phòng ngủ
Bedside	cạnh giường
Bedsore	(y học) chứng thối loét vì nằm liệt giường
Bedspread	khăn trải giường
Bedstead	khung giường
Bedtick	chăn lông phủ giường
Bedtime	giờ đi ngủ
Bee	con ong
Beeb	công ty phát thanh anh quốc (bbc)
Beech	(thực vật học) cây sồi
Beechen	(thuộc) cây sồi
Beef	thịt bò
Beef cattle	trâu bò vỗ béo (để ăn thịt)
Beef tea	nước thịt bò hầm
Beefburger	thịt bò băm viên
Beefeater	người thích ăn thịt bò
Beefiness	vẻ lực lưỡng, sự có bắp thịt rắn chắc
Beefsteak	thịt bít tết
Beefy	lực lưỡng, có bắp thịt rắn chắc
Beehive	tổ ong
Been	thì, là
Beep	(tech) tiếng bíp (phát từ máy)
Beeper	(tech) máy bíp, máy điện liên (liên lạc báo có điện thoại)
Beeper box	(tech) máy bíp, điện liên
Beer	bia
Beerhouse	quán bia
Beery	(thuộc) bia
Beestings	sữa non của bò mới đẻ
Beeswax	sáp ong
Beeswing	cặn rượu để lâu năm
Beet	(thực vật học) cây củ cải đường
Beetle	cái chày
Beetling	cheo leo, nhô ra
Beetroot	củ cải đường
Beeves	thịt bò
Beezer	(từ lóng) cái mũi
Befall	xảy đến, xảy ra
Befallen	xảy đến, xảy ra
Befell	xảy đến, xảy ra
Befit	thích hợp, hợp với
Befitting	thích hợp, hợp với
Befittingly	thích hợp, hợp cách
Befog	phủ sương mù
Before	trước
Beforehand	sẵn sàng trướcc
Befoul	làm nhơ bẩn, làm nhơ nhuốc (nghĩa đen) & (nghĩa bóng)
Befriend	đối xử tốt, đối xử như bạn
Beft	đới đai
Befuddle	làm ngớ ngẩn, làm đần độn, làm mụ đi
Beg	ăn xin
Begad	trời ơi! trời đất ơi!
Began	bắt đầu, mở đầu, khởi đầu
Begetter	người gây ra, người sinh ra
Beggar	người ăn mày, người ăn xin
Beggardom	giới ăn mày, những người ăn mày
Beggarliness	tình trạng nghèo nàn cơ cực
Beggarly	nghèo nàn, cơ cực
Beggary	cảnh nghèo khó xác xơ
Begin	bắt đầu
Begin block	(tech) khối bắt đầu
Begin column	(tech) cột bắt đầu
Begin window	(tech) bắt đầu cửa xổ
Beginner	người bắt đầu
Beginning	bắt đầu
Begird	buộc quanh, đánh đai quang, bao quanh
Begirt	buộc quanh, đánh đai quang, bao quanh
Begone	biến đi
Begonia	(thực vật học) cây thu hải đường
Begrime	làm nhọ nhem
Begrudge	ghen tị
Begrudgingly	ghen tị, thèm muốn
Beguiling	lý thú, hấp dẫn
Beguilingly	lý thú, hấp dẫn
Begum	người đàn bà hồi giáo thuộc đẳng cấp thượng lưu
Begun	bắt đầu, mở đầu, khởi đầu
Behalf	thay mặt
Behave	hành xử
Behavior	hành vi
Behaviour	thái độ, cách đối xử
Behavioural	thuộc về cách cư xử
Behaviourism	(triết học) chủ nghĩa hành vi
Behead	chặt đầu, chém đầu
Beheld	nhìn ngắm
Behemoth	con vật kếch xù
Behest	(thơ ca) chỉ thị, mệnh lệnh ((từ cổ,nghĩa cổ) (cũng) hest)
Behind	phía sau
Behindhand	muộn, chậm
Behold	nhìn ngắm
Beholden	chịu ơn
Beholder	người xem, người ngắm
Beige	vải len mộc
Being	đang
Bejewelled	được trang trí hoặc tô điểm bằng đồ châu báu
Bel	(tech) ký tự tiếng chuông
Belabour	đánh nhừ tử, nện một trận nên thân (nghĩa đen) & bóng
Belaid	cột (thuyền) lại
Belated	đến muộn, đến chậm
Belatedly	chậm, muộn
Belaud	hết lời ca ngợi, hết lời tán dương
Belay	cột (thuyền) lại
Belch	sự ợ
Belcher	khăn quàng hai màu
Beldam	mụ phù thuỷ già, mụ đồng gia
Beleaguer	vây, bao vây
Belemnite	(địa lý,địa chất) con tên đá (động vật hoá thạch)
Belfry	tháp chuông
Belgian	(thuộc) bỉ
Belie	gây một ấn tượng sai lầm
Belief	niềm tin
Belief revision	(tech) duyệt lại tín nhiệm (trí năng nhân tạo)
Believable	có thể tin được
Believably	đáng tin
Believe	tin
Believer	người tin, tín đồ
Belike	(từ cổ,nghĩa cổ) có lẽ, không chừng
Belisha beacon	cột có ánh sáng màu da cam nháy sáng ở đỉnh
Belittle	làm bé đi, thu nhỏ lại
Belittlement	sự xem nhẹ, sự xem thường
Belittling	làm giảm uy tín, làm giảm giá trị
Bell	chuông
Bell captain	người trực tầng ở khách sạn, câu lạc bộ
Belladonna	(thực vật học) cây benlađôn, cây cà dược
Belle	người đàn bà đẹp nhất, hoa khôi
Belletrist	nhà văn
Belletristic	(thuộc) văn chương
Bellicose	hiếu chiến, thích đánh nhau, hay gây gỗ
Bellicosity	tính hiếu chiến, tính thích đánh nhau, tính hay gây gỗ
Bellied	tính từ
Belligerence	tình trạng đang giao tranh
Belligerency	tình trạng đang giao tranh
Belligerent	tham chiến
Bellow	tiếng bò rống
Bellows	kêu
Belly	bụng
Bellyache	bệnh đau bụng
Bellybutton	rốn (ở bụng)
Bellyful	bụng (đầy)
Belong	thuộc về
Belongings	của cải
Beloved	được yêu mến, được yêu quý
Below	phía dưới
Belt	thắt lưng
Beltane	(sử học) ngày hội mồng 1 tháng 5 (theo kiểu cổ)
Belting	trận đòn
Belvedere	tháp lầu
Bemire	bôi bùn
Bemoan	than khóc, nhớ tiếc (ai, cái gì)
Bemuse	làm sửng sốt, làm kinh ngạc
Ben	đỉnh núi
Bench	Băng ghế
Bench dog	chó trưng bày, chó triển lãm
Benchmark	(tech) tiêu chuẩn, cơ chuẩn
Benchmark program	(tech) chương trình kiểm chuẩn
Benchmark test	(tech) thử chuẩn, kiểm chuẩn
Bend	bẻ cong
Bending	sự uốn
Bendy	(nói về đường sá) quanh co khúc khủyu
Beneath	ở trên
Benedick	người mới cưới vợ
Benedictine	thầy tu theo dòng thánh bê-nê-đích
Benediction	lễ giáng phúc
Benedictory	(thuộc) sự giáng phúc
Benefaction	việc thiện, việc nghĩa
Benefactor	người làm ơn
Benefactress	người làm ơn
Benefice	(tôn giáo) tiền thu nhập
Beneficence	tính từ thiện, từ tâm
Beneficent	hay làm phúc, hay làm việc thiện, từ thiện, từ tâm, thương người
Beneficently	hay làm phúc, từ thiện, từ tâm, thương người
Beneficial	có ích
Beneficially	hữu ích, ích lợi
Beneficiary	người hưởng hoa lợi
Benefit	lợi ích
Benevolence	lòng nhân từ, lòng nhân đức, lòng từ thiện
Benevolent	nhân từ, nhân đức, từ thiện, thương người
Benevolently	nhân hậu, nhân từ
Bengal	(thuộc) băng-gan
Bengal light	pháo hoa
Bengalee	(thuộc) băng-gan
Benifit	quyền lợi, lợi ích
Benighted	bị lỡ độ đường (vì đêm tối)
Benign	lành
Benignancy	lòng tốt, lòng nhân từ
Benignant	lành
Benignity	lòng tốt, lòng nhân từ
Benignly	nhân từ, nhân hậu, tử tế
Benison	(từ cổ,nghĩa cổ) sự ban ơn, sự ban phúc
Benjamin	(như) benzoin
Bent	khiếu, sở thích
Benthamism	thuyết ben-tam, thuyết vị lợi
Benthamite	người vị lợi
Benthos	(sinh vật học) sinh vật đáy
Benumb	làm cho cóng
Benzene	(hoá học) benzen ((cũng) benzol)
Benzoate	(hoá học) benzoat
Benzoic	(hoá học) benzoic
Benzoin	cánh kiến trắng, an tức hương
Benzol	(hoá học) benzen ((cũng) benzene)
Bequeath	để lại (bằng chúc thư)
Bequest	sự để lại (bằng chúc thư)
Berate	mắng mỏ, nhiếc móc
Berberis	(thực vật học) giống cây hoàng liên gai
Bere	(thực vật học) lúa mạch
Bereave	làm mất
Bereaved	gia quyến của người quá cố, tang quyến
Bereavement	sự mất, sự tổn thất (khi bà con hay bạn bè mất đi)
Bereft	làm mất
Beret	núi băng
Berg	(nam phi) núi, đồi
Bergamot	cam becgamôt
Beside	bên cạnh
Besides	ngoài ra
Besiege	(quân sự) bao vây, vây hãm
Besieger	người bao vây
Besmear	bôi bẩn, làm nhớp nháp
Besmirch	bôi bẩn, làm lem luốc
Besom	chổi sể
Besot	làm mụ người, làm đần độn
Besought	cầu xin, cầu khẩn, van xin
Bespangle	dát trang kim
Bespatter	rắc, vảy, làm bắn tung toé
Bespeak	đặt trước, giữ trước, đặt (hàng)
Bespectacled	đeo kính
Bespoke	đặt trước, giữ trước, đặt (hàng)
Bespoken	đặt trước, giữ trước, đặt (hàng)
Besprent	(thơ ca) rải rác
Besprinkle	vảy, rắc, rải
Best	tốt
Best approximation	(tech) ứớc lượng gần đúng nhất
Best girl	(thông tục) người yêu, người tình
Best linear unbiased estimator	(econ) (blue)-đoán số trùng tuyến tính đẹp nhất
Best looker	(từ mỹ,nghĩa mỹ),  (thông tục) chàng đẹp trai
Best man	người phù rể
Best seller	cuốn sách bán chạy nhất
Bestead	giúp đỡ, giúp ích cho
Bested	giúp đỡ, giúp ích cho
Bestial	(thuộc) súc vật, có tính súc vật
Bestiality	thú tính
Bestialize	làm thành cục súc, làm thành độc ác, làm cho dã man, làm cho có đầy thú tính
Bestially	thô lỗ, cộc cằn, hung tợn
Bestir	khuấy động
Bestow	bestow on,  upon tặng cho, ban cho, dành cho
Bestowal	sự tặng, sự cho
Bestrew	rắc, rải, vãi
Bestrid	ngồi giạng chân trên, đứng giạng hai chân trên
Bet	cá cược
Beta	thử nghiệm
Beta rays	tia bêta
Beta site	vị trí b-kiểm
Beta software	phần mềm beta
Beta test	b-kiểm, thứ kiểm
Betatron	bêtatron
Betel	cây trầu không
Bethel	nhà thờ của những người không theo quốc giáo
Bethink	nhớ ra, nghĩ ra
Bethought	nhớ ra, nghĩ ra
Betid	xảy đến, xảy ra
Betide	xảy đến, xảy ra
Betimes	sớm
Betoken	báo hiệu, chỉ rõ
Beton	bê tông
Betony	(thực vật học) cây hoắc hương
Betook	dấn thân vào, mắc vào, đam mê
Betrayal	sự phản bội
Betrothal	sự hứa hôn
Betrothed	người hứa hôn, chồng chưa cưới, vợ chưa cưới
Better	tốt hơn
Betterment	sự làm tốt hơn, sự cải tiến, sự cải thiện
Betting	sự đánh cuộc
Bettor	cấp so sánh của good
Between	giữa
Between girl	cô hầu phụ
Betwixt	(từ cổ,nghĩa cổ) (như) between
Bevel	góc xiên, cạnh xiên
Bevel gear	(cơ) bánh răng nón
Bevel pinion	(kỹ thuật) bánh răng nón
Beverage	đồ uống
Bevy	nhóm, đoàn, bầy (đàn bà, con gái)
Bewail	than phiền, than vãn, khóc than, thương tiếc
Beware	cẩn thận, chú ý
Bewilder	làm bối rối, làm hoang mang, làm lúng túng
Bewildering	gây bối rối, khiến hoang mang
Bewilderment	sự bối rôi, sự hoang mang
Bewitch	bỏ bùa mê
Bewitching	làm say mê, làm mê mẩn, làm say đắm
Bewitchment	sự bỏ bùa mê
Bewithchingly	quyến rũ, hấp dẫn
Bewray	(từ cổ,nghĩa cổ) vô tình mà tiết lộ
Bey	bây (thống đốc ở thổ nhĩ kỳ)
Beyond	vượt ra ngoài
Bezel	mép vát (kéo)
Bezier curve	đường cong bézier
Bezique	môn chơi bài dành cho hai người, và dùng cỗ bài đúp (64 lá)
Bfpo	quân bưu anh
Bhang	cây gai dầu
Bi	(tiền tố) hai
Biadaptive	(tech) thích ứng kép = backward learning
Biaffine	song afin
Biangular	có hai góc
Biannual	một năm hai lần
Bias	sự thiên vị
Bias binding	miếng vải cắt chéo để buộc các mép lại
Biased	(thống kê) chệch
Biasing	(tech) định thiên
Bib	cái yếm dãi (của trẻ con)
Bibber	người nghiện rượu
Bible	Kinh Thánh
Biblical	(thuộc) kinh thánh
Bibliofilm	phim sách (phim ảnh chụp lại sách)
Bibliograph	người sưu tầm thư mục, cán bộ thư mục
Bibliographer	người sưu tầm thư mục, cán bộ thư mục
Bibliographic	(thuộc) thư mục
Bibliographical	(thuộc) thư mục
Bibliography	thư mục
Bibliolater	người tôn sùng sách
Bibliolatry	sự tôn sùng sách
Bibliomania	bệnh mê sách
Bibliomaniac	người mê sách
Bibliophile	người ham sách
Bibliophilism	sự ham sách, tính ham sách
Bibliophilist	người ham sách
Bibliopole	người bán sách hiếm
Bibliopoly	nghề bán sách
Bicameral	có cả thượng nghị viện lẫn hạ nghị viện, lưỡng viện
Bicarb	<khngu> bicarbonat natri
Bicarbonate	(hoá học) cacbonat axit
Bicarmeral	có hai nghị viện (chế độ)
Bicategory	song phạm trù
Bicentenanial	lễ kỷ niệm hai trăm năm
Bicentenary	hai trăm năm
Bicentennial	hai trăm năm một lần
Bicephalous	có hai đầu
Biceps	(giải phẫu) có hai đầu
Bicharacteristic	song đặc trưng
Bichloride	(hoá học) điclorua
Bichromate	(hoá học) đicromat
Bicker	cãi nhau vặt
Bicompact	song compăc
Bicompactification	song compăc hoá
Bicompactum	song compăc
Bicomplex	song phức
Biconcave	(vật lý) hai mặt lõm
Biconical antenna	(tech) ăngten hai chóp
Biconjugate gradient method	(tech) phương pháp thang độ liên hợp song đối
Biconvex	(vật lý) hai mặt lồi
Biconvex lens	(tech) thấu kính hai mặt lõm
Bicuspid	có hai đầu nhọn
Bicycle	Xe đạp
Bicycler	(từ mỹ,nghĩa mỹ) (như) bicyclist
Bicyclist	người đi xe đạp
Bicylinder	song trụ
Bid	sự đặt giá, sự trả giá (trong một cuộc bán đấu giá)
Biddable	vâng lời, chịu tuân lệnh
Bidden	sự đặt giá, sự trả giá (trong một cuộc bán đấu giá)
Bidder	người trả giá
Bidding	sự đặt giá
Bide	to bide one's time đợi thời cơ
Bidet	chậu dùng để rửa bộ phận sinh dục và hậu môn
Bidirectional	(tech) thuộc song hướng, thuộc hai hướng
Bidual	(tech) song đối ngẫu
Biennial	lâu hai năm
Biennially	hai năm một lần
Bieqiuvalence	song tương đương
Bier	đòn đám ma
Bifactorial	hai nhân tố
Bifecnode	song flecnôt
Biff	(từ lóng) cú đấm mạnh
Biffin	táo đỏ (để nấu ăn)
Bifid	chẻ đôi
Bifilar	(tech) hai dây, dây chập đôi
Bifocal	hai tròng (kính đeo mắt)
Bifocals	kính hai tròng
Bifunctor	song hàm tử, hai tử hai ngôi
Bifurcate	chia hai nhánh, rẽ đôi
Bifurcation	chia làm hai nhánh, rẽ đôi
Big	lớn
Big blue	tên lóng của công ty máy tính ibm
Big brother	kẻ độc tài nhưng vẫn ra vẻ tử tế
Big bug	(từ lóng) nhân vật quan trọng
Big business	việc kinh doanh có quy mô lớn
Big dipper	đường sắt hẹp và quanh co (ở các hội chợ)
Big end	cái cán của tay quay
Big game	môn săn bắn những loại thú lớn
Big gun	(quân sự) pháo
Big head	(từ mỹ,nghĩa mỹ) người làm bộ, người tự phụ, người hay vỗ ngực ta đây
Big house	(từ mỹ,nghĩa mỹ),  (từ lóng) nhà tù khổ sai
Big noises	tiếng to, tiếng ầm ầm
Big push	(econ) cú đẩy mạnh.
Big shot	(từ lóng) (như) big_bug
Big stick	(từ mỹ,nghĩa mỹ) sự phô trương lực lượng
Big top	lều chính ở rạp xiếc
Big tree	(thực vật học) (từ mỹ,nghĩa mỹ) (như) sequoia
Big wheel	trò chơi đu quay ở các khu vui chơi
Bigamist	người có hai vợ, người có hai chồng
Bigamous	có hai vợ, có hai chồng
Bigamously	trong tình trạng song hôn
Bigamy	sự lấy hai vợ, sự lấy hai chồng
Bigenus	giống kép
Bight	chỗ lõm vào, chỗ cong (ở bờ biển)
Bigin	bắt đầu
Biginning	sự bắt đầu
Bigot	người tin mù quáng
Bigoted	tin mù quáng
Bigotry	sự tin mù quáng
Bigrade	song cấp
Bigwig	nhân vật quan trọng, quan to
Biharmonic	song điều hoà
Biholomorphic	song chỉnh hình
Bijection	song ánh
Bijou	đồ nữ trang
Bijoux	đồ nữ trang
Bike	xe đạp
Bikini	áo tắm hai mảnh
Bilabial	âm do hai môi nhập lại phát ra ((chẳng hạn b, m, p...))
Bilabiate	(thực vật học) hai môi (hoa)
Bilabong	nhánh sông tạo nên chỗ nước đọng
Bilateral	hai bên
Bilbo	(sử học) cái gươm
Bilboes	còng sắt, cùm sắt (để cùm tù nhân)
Bile	mặt
Bilevel resist	(tech) lớp cản hai cấp
Bilge	đáy tàu
Bilharzia	bệnh do giun ở trong máu và bàng quang gây ra
Biliary	(thuộc) mật
Bilinear	song tuyến tính
Bilinear system	(tech) hệ thống song tuyến
Bilingual	sử dụng hai thứ tiếng, thông thạo hai thứ tiếng, song ngữ
Bilious	(thuộc) mật
Biliously	hay gắt, bẳn tính, dễ cáu
Biliousness	sự nhiều mật
Bilk	quịt, trốn (nợ)
Bilker	người trốn nợ
Bill	hóa đơn
Bill of rights	bản tuyên ngôn nhân quyền
Bill of sale	văn bản ghi nhận việc mua bán tài sản tư nhân
Billboard	(từ mỹ,nghĩa mỹ) bảng dán thông cáo, bảng dán yết thị
Billboard antenna	(tech) ăngten bảng
Billet	thanh củi
Billhook	dụng cụ dùng để tỉa cây
Billiarsgate	chợ cá (ở luân đôn)
Billion	tỷ
Billionaire	(từ mỹ,nghĩa mỹ) nhà tỉ phú
Billow	sóng to
Billyboy	(hàng hải) thuyền buồm nhỏ
Billycock	mũ quả đưa
Bilobate	có hai thuỳ
Bilobed	có hai thuỳ
Bilocular	có hai ngăn
Bilologist	nhà sinh vật học
Biltong	thịt khô thỏi (thái thành từng thỏi)
Bilulous	thấm nước, hút nước
Bimanal	có hai tay
Bimane	động vật hai tay
Bimanous	có hai tay
Bimetal	lưỡng kim
Bimetallic	lưỡng kim
Bimetallism	chế độ hai bản vị (về tiền tệ)
Bimetallist	người tán thành chế độ hai bản vị (về tiền tệ)
Bimodal	hai mốt
Bimodule	song môđun
Bimonthly	mỗi tháng hai lần
Bimos integrated circuit	(tech) mạch tích hợp bimos
Bimotored	có hai động cơ (máy bay...)
Bin	thùng
Binariants	song biến thức
Binate	thành đôi, thành cặp
Binaural	(thuộc) hai tai
Binaural effect	(tech) hiệu ứng nghe hai tai
Bind	trói buộc
Binder	người đóng sách
Bindery	(từ mỹ,nghĩa mỹ) hiệu đóng sách
Binding	sự liên kết, sự ghép lại, sự gắn lại, sự trói lại, sự buộc lại, sự bó lại
Bindlestiff	(từ mỹ,nghĩa mỹ),  (từ lóng) kẻ lang thang, ma cà bông
Bindweed	(thực vật học) giống cây bìm bìm
Bine	(thực vật học) chồi
Binge	(từ lóng) cuộc chè chén say sưa
Bingo	một loại trò chơi cờ bạc
Binit	(tech) cơ số hai
Binnacle	(hàng hải) hộp la bàn
Binocular	hai kính mắt
Binoculars	ống nhòm
Binodal	(thuộc) nút kép
Binode	nút kép
Binomial	(tech) nhị thức
Binominal	(toán học) nhị thức
Binormal	phó pháp tuyến
Bint	(từ lóng) cô gái
Biochemical	(thuộc) hoá sinh
Biochemist	nhà hoá sinh
Biochemistry	hoá sinh
Biochip	(tech) chip sinh tính
Biocomputer	(tech) máy điện toán sinh tính
Biodegradable	có thể bị vi khuẩn làm cho thối rữa
Bioelectric	(tech) thuộc điện sinh vật
Bioelectricity	(tech) môn điện sinh vật
Bioelectronics	(tech) môn điện tử sinh vật
Biogenesis	thuyết phát sinh sinh vật
Biogenetic	(thuộc) thuyết phát sinh sinh vật
Biogenetical	(thuộc) thuyết phát sinh sinh vật
Biogeny	thuyết phát sinh sinh vật
Biogeography	ngành địa lý sinh vật
Biographer	người viết tiểu sử
Biographic	(thuộc) tiểu sử
Biographical	(thuộc) tiểu sử
Biographically	xem biographical
Biography	tiểu sử
Biologic	(thuộc) sinh vật học
Biological	sinh học
Biological control	sự diệt vật hại bằng phương pháp sinh học
Biologically	về mặt sinh học
Biologist	nhà nghiên cứu về sinh vật học
Biology	sinh học
Bioluminescence	sự phát quang sinh học
Bioluminescent	phát quang sinh học
Biomaterial	chất liệu làm những bộ phận nhân tạo trong cơ thể (gắn trực tiếp vào các mô sống)
Biomathematics	toán sinh
Biome	quần xã sinh vật
Biometric	(thuộc) sinh trắc học
Biometrical	(thuộc) sinh trắc học
Biometrically	xem biometrics
Biometrician	nhà sinh trắc học
Biometrics	sinh trắc học
Biometry	sinh trắc học
Bionic	có những bộ phận được điều khiển bằng điện tử|* danh từ, pl
Bionics	(sinh vật học) kỹ thuật
Bionomics	sinh thái học
Biophysical	(thuộc) lý sinh
Biophysically	xem biophysics
Biophysicist	nhà lý sinh
Biophysics	lý sinh
Biopic	phim về cuộc đời của một nhân vật có thật
Bioplasm	(sinh vật học) sinh chất
Biopsic	xem biopsy
Biopsy	(y học) sinh thiết
Biorhythm	nhịp sinh học
Biorthogonal	song trực giao
Biorthogonalization	sự song trực giao hoá
Biorythm	nhịp sinh học
Bios	hệ vào/ra cơ sở
Bioscience	sinh học
Bioscope	rạp chiếu bóng ở nam phi
Biosensor	(tech) đầu cảm thụ sinh vật
Biosphere	sinh quyển
Biostatistics	thống kê sinh vật học
Biosynthesis	số nhiều biosyntheses
Biota	khu sinh vật, vùng sinh vật
Biotechnical	xem biotechnology
Biotechnological	xem biotechnology
Biotechnology	công nghệ sinh học
Biparental	thuộc hai cha mẹ
Bipart	hai tầng
Bipartisan	(thuộc) hai đảng
Bipartisanism	xem bipartisan
Bipartisanship	xem bipartisan
Bipartite	(thực vật học) chia đôi (lá)
Bipartitely	xem bipartite
Bipartition	sự chia đôi, sự phân đôi
Biped	có hai chân (động vật)
Biphase	(tech) hai vị tướng
Biplane	máy bay hai tầng cánh
Bipod	giá hai chân
Bipolar	(điện học) hai cực, lưỡng cực
Bipolarity	xem bipolar
Biquadratic	(toán học) trùng phương
Biquaternion	song qua - tenion
Biquinary	(tech) cơ hai và năm
Biracial	đại điện hoặc gồm hai chủng tộc
Biramous	chẻ đôi
Birational	song hữu tỷ
Birch	giống cây cáng lò, giống cây bulô
Birchbark	(từ mỹ) ca nô làm bằng vỏ cây bulô
Bird	chim
Bird of paradise	chim seo cờ
Bird of passage	người sống rày đây mai đó
Bird of prey	chim săn mồi
Bird sanctuary	khu bảo tồn chim
Birdbrained	ngu xuẩn, ngốc nghếch
Birdie	chim non
Birding	xem bird
Birdman	người nuôi chim
Birdseed	hạt dùng cho chim ăn
Birdsong	tiếng hót của chim
Birdwoman	nữ phi công
Birectangular	có hai góc vuông
Birefringent discriminator	(tech) bộ phân biệt song chiết
Biregular	song chính quy
Biretta	mũ màu đen của các giáo sự thiên chúa giáo
Biro	bút bi
Birse	lông cứng hoặc một chùm lông cứng
Birth	Sinh
Birth rate	(econ) tỷ suất sinh
Birthday	sinh nhật
Birthplace	nơi sinh
Birthright	quyền lợi dòng nòi
Birthstone	viên đá quý gắn một cách tượng trưng với tháng sinh
Birthwort	cây dây leo
Bis	(econ) ngân hàng thanh toán quốc tế
Biscuit	bánh quy
Bise	gió bắc hoặc đông bắc hanh khô
Bisecant	song cát tuyến
Bisect	chia đôi, cắt đôi
Bisection	sự chia đôi, sự cắt đôi
Bisector	đường phân đôi
Biserial	hai chuỗi
Bisexual	(sinh vật học) lưỡng tính
Bisexuality	sự lưỡng tính, tính cách lưỡng tính
Bish	(từ lóng) lỗi
Bishop	giám mục
Bishopric	địa phận của giám mục
Bisk	xúp thịt chim
Bismutite	(khoáng chất) bitmutit
Bison	bò rừng bizon
Bisontine	thuộc bò rừng bizon
Bisque	sứ không tráng men
Bissextile	năm nhuận
Bistable	(tech) trạng thái song ổn, ổn kép
Bistable device	(tech) bộ song ổn thái
Bistort	(thực vật học) cây quyền sâm
Bistoury	(y học) dao mổ
Bistre	màu nâu sẫm
Bistro	quán rượu nhỏ
Bisulfate	(hoá học) sunfat-axit
Bisymmetric	song đối xứng
Bit manipulation	(tech) thao tác bit
Bit part	vai thứ yếu, vai phụ
Bitable	xem bite
Bitangent	lưỡng tiếp (tiếp xúc tại hai điểm)
Bitch	con chó sói cái, con chồn cái
Bitchiness	ý xấu, ác ý
Bitchy	có ác ý
Bite	cắn
Biteable	xem bite
Biter	người cắn, vật cắn
Bitewing	phim chụp tia x chân răng cả hàm trên hàm dưới
Bitiminize	rải nhựa đường, quét bitum
Biting	làm cho đau đớn, làm buốt, làm nhức nhối
Bitingly	xem biting
Bitmap	hình chấm, bản đồ tổng hợp bit
Bitmap display	biểu thị bằng hình chấm/bitmap
Bitmap font	dạng chữ chấm (vuông)
Bitnet	tên mạng toàn cục liên kết các trường cao đẳng và đại học ở mỹ, canada, châu âu
Bitsy	nhỏ xíu
Bitt	cọc trên sàn tàu để đỡ dây cáp
Bitter	đắng
Bitterish	hơi đắng
Bitterling	một loại cá nước ngọt
Bittern	(động vật học) con vạc
Bitterness	vị đắng
Bittersweet	một cái gì vừa ngọt vừa đắng
Bittock	tí chút, mẫu nhỏ
Bitts	(hàng hải) cọc buộc dây cáp
Bitumen	nhựa rải đường bitum
Bituminize	rải nhựa đường, quét bitum
Bituminous	có nhựa rải đường, có bitum
Bitwise	(tech) phân theo bit
Biunique	một đối một
Bivalent	(hoá học) có hoá trị hai
Bivalve	(sinh vật học) hai mảnh vỏ
Biyearly	hai năm một lần
Biz	(thông tục) (như) business
Bizonal	tình trạng một vùng có hai chính quyền cùng hoạt động
Blabbermouth	người ăn nói ba hoa
Blabby	xem blab
Black	đen
Blackfellow	thổ dân úc
Blackfish	cá đen
Blackfly	số nhiều blackflies
Blackguard	người đê tiện
Blackguardly	đê tiện
Blackhead	mụn trứng cá
Blackheart	bệnh làm khoai tây đen ruột
Blacking	xi đen (đánh giày)
Blacking brush	bàn chải đánh giày
Blackish	hơi đen, đen đen
Blackjack	dùi cui của cảnh sát
Blackleg	kẻ phản bội ở lại làm cho chủ
Blacklist	danh sách đen, sổ bìa đen
Blacklister	xem blacklist
Blackly	xem black
Blackmail	sự hâm doạ để tống tiền
Blackmailer	người hâm doạ để làm tiền
Blackness	màu đen
Blackout	(tech) mất liên lạc
Blacksmith	thợ rèn
Blacksmithing	xem blacksmith
Blacksnake	(từ mỹ) roi da (dài)
Blackthorn	(thực vật học) cây mận gai
Blacktop	nhựa rải mặt đường
Blackwood	cây keo cao ở úc
Blacky	người da đen
Bladder	bong bóng
Bladdery	như bong bóng, như bọng
Blade	lưỡi
Bladed	xem blade
Blaeberry	cây việt quất
Blah	lời nói huênh hoang, ba hoa
Blain	mụn mủ, mụn rộp
Blamable	đáng khiển trách, đáng trách mắng
Blamableness	xem blamable
Blamably	xem blamable
Blame	khiển trách
Blameful	khiển trách, trách mắng
Blamefully	xem blameful
Blamefulness	xem blameful
Blameless	không thể khiển trách được
Blamelessly	không thể chê được
Blamelessness	xem blameless
Blamer	xem blame
Blameworthiness	xem blameworthy
Blameworthy	đáng khiển trách, đáng trách mắng
Blanch	làm trắng, làm bạc đi
Blancher	xem blanch
Bland	có cử chỉ dịu dàng, lễ phép
Blandish	xu nịnh, bợ đỡ, tán tỉnh, lấy lòng
Blandisher	xem blandish
Blandishment	sự xu nịnh
Blandly	dịu dàng, ôn tồn
Blandness	sự dịu dàng lễ phép
Blank	chỗ trống
Blanket	cái mền
Blankness	xem blank
Blanquette	món ragu hoặc thịt bê hầm
Blare	tiếng kèn
Blarney	lời dỗ ngọt, lời tán tỉnh đường mật
Blaspheme	báng bổ
Blasphemer	người ăn nói báng bổ
Blasphemous	báng bổ
Blasphemously	báng bổ, hồ đồ
Blasphemousness	xem blasphemous
Blasphemy	lời báng bổ
Blast	vụ nổ
Blasted	đáng nguyền rủa, đáng cho trời đánh thánh vật
Blastema	mầm gốc, nha bào
Blaster	xem blast
Blasting	sự làm nổ tung, sự phá bằng thuốc nổ
Blastocoel	cũng blastocoele
Blastoderm	bì phôi
Blastomere	phôi bào
Blastomycete	họ nấm chồi
Blastomycosis	bệnh nấm chồi
Blastoporal	cách viết khác : blastoporic
Blastopore	(sinh học) lỗ phôi, miệng phôi
Blastosphere	(sinh học) phôi cầu
Blastospheric	thuộc phôi cầu
Blastula	số nhiều blastulas,  blastulae
Blastular	thuộc phôi nang
Blastulation	sự hình thành phôi túi
Blatancy	tính hay la lối
Blatant	hay kêu la, hay la lối, hay làm om xòm
Blatantly	rành rành, hiển nhiên
Blate	nhút nhát
Blather	sự nói bậy bạ
Blatherer	xem blather
Blaze	ngọn lửa
Blazer	cháy rực
Blazing	nóng rực
Blazingly	xem blaze
Blazon	huy hiệu (in trên mộc)
Blazoner	xem blazon
Blazonment	sự vẽ huy hiệu
Blazonry	nghệ thuật làm huy hiệu
Bleach	tẩy trắng, chuội (vải)
Bleacher	thợ chuội (vải)
Bleaching powder	vôi clorua
Bleak	trống trải
Bleakly	thất vọng, chán chường
Bleakness	xem bleak
Blear	mờ
Blearily	lờ đờ, mệt mỏi
Bleariness	xem bleary
Bleary	mờ mắt
Bleat	tiếng be be (của cừu, bê, dê)
Bleater	xem bleat
Bled	mụn nước, mụn phỏng (ở da)
Bleed	chảy máu, mất máu
Bleeder	người trích máu
Bleeding	sự chảy máu
Bleep	tiếng bíp bíp
Bleeper	thiết bị phát ra tiếng bíp bíp
Blellum	một người lười biếng chỉ nói mồm
Blemish	tật
Blemisher	xem blemish
Blench	lùi bước, chùn bước
Blencher	xem blench
Blend	trộn
Blende	(khoáng chất) blenđơ
Blenny	cá lon mây
Blepharitis	bệnh viêm mí mắt
Blepharoplast	(sinh học) thể gốc lông
Blesbok	loại linh dương ở nam phi
Bless	ban phước
Blessed	thần thánh
Blessedness	phúc lành
Blessing	phước lành
Blest	giáng phúc, ban phúc
Blet	chỗ ủng, chỗ thối
Blether	sự nói bậy bạ
Blewits	số nhiều blewits
Blight	bệnh tàn rụi (cây cối)
Blighter	kẻ phá hoại
Blimp	khí cầu nhỏ
Blimpery	thái độ ngoan cố, phản đông
Blimpish	ngoan cố phản động
Blimpishness	tính ngoan cố phản động
Blin	số nhiều blini,  blinis
Blind	mù quáng
Blinders	miếng (da, vải) che mắt (ngựa)
Blindfish	loại cá mắt nhỏ không nhìn thấy được
Blindfold	bị bịt mắt
Blindfolded	xem blindfold
Blinding	đá dăm
Blindingly	xem blind
Blindly	mù, mù quáng
Blindness	sự đui mù
Blingual	biết nói hai thứ tiếng
Blink	chớp mắt
Block	khối
Blond	tóc vàng
Blood	máu
Bloody	dính máu
Blow	thổi
Blue	màu xanh da trời
Board	bảng
Boast	khoe khoan
Boat	thuyền
Body	thân hình
Boil	sôi lên
Bold	Dũng cảm
Bolt	chớp
Bomb	quả bom
Bombing	ném bom
Bond	liên kết
Bone	khúc xương
Bonus	thưởng
Book	sách
Boom	sự bùng nổ
Boost	tăng
Boot	khởi động
Booth	gian hàng
Border	biên giới
Boring	nhàm chán
Born	sinh ra
Borrow	vay
Boss	trùm
Both	cả hai
Bother	làm phiền
Bottle	chai
Bottom	đáy
Bounce	tung lên
Boundary	ranh giới
Bow	cây cung
Bowl	bát
Box	cái hộp
Boy	con trai
Boyfriend	bạn trai
Brain	óc
Brake	phanh
Branch	chi nhánh
Brand	nhãn hiệu
Brave	can đảm
Bread	bánh mỳ
Break	phá vỡ
Breakfast	bữa ăn sáng
Breast	nhũ hoa
Breath	hơi thở
Breathe	thở
Breathing	thở
Breeze	khoe khoang
Brick	gạch
Bride	cô dâu
Bridge	cầu
Brief	ngắn gọn
Briefly	ngắn gọn
Bright	sáng
Brilliant	rực rỡ
Bring	mang đến
British	người Anh
Broad	rộng lớn
Broadcast	phát sóng
Broken	bị hỏng
Broker	người môi giới
Bronze	đồng
Brother	em trai
Brown	nâu
Brush	chải
Brutal	tàn bạo
Bubble	bong bóng
Buck	buck
Bucket	cái xô
Buddy	Bạn bè
Budget	ngân sách
Bug	lỗi
Build	xây dựng
Builder	người xây dựng
Building	Tòa nhà
Bulb	bóng đèn
Bulk	số lượng lớn
Bull	con bò
Bullet	đạn
Bunch	bó
Burden	gánh nặng
Bureau	phòng làm việc
Burn	đốt cháy
Burning	đốt
Burst	nổ
Bury	chôn
Bus	xe buýt
Bush	cây bụi
Business	kinh doanh
Businessman	doanh nhân
Busy	bận
But	nhưng
Butt	mông
Butter	bơ
Butterfly	Con bướm
Button	nút
Buy	mua
Buyer	người mua
By	bởi
Cab	taxi
Cabin	khoang cabin
Cabinet	buồng
Cable	cáp
Cage	cái lồng
Cake	bánh ngọt
Calculate	tính toán
Calculation	phép tính
Calendar	lịch
Call	gọi
Calm	điềm tĩnh
Camera	Máy ảnh
Camp	trại
Campaign	chiến dịch
Campus	khuôn viên
Can	có thể
Canadian	người Canada
Cancel	hủy bỏ
Cancer	ung thư
Candidate	ứng viên
Candle	nến
Candy	Cục kẹo
Canvas	Tranh sơn dầu
Cap	mũ lưỡi trai
Capability	khả năng
Capable	có khả năng
Capacity	sức chứa
Capital	thủ đô
Captain	đội trưởng
Capture	nắm bắt
Car	xe hơi
Carbohydrate	carbohydrate
Carbon	carbon
Card	Thẻ
Care	quan tâm
Career	nghề nghiệp
Careful	cẩn thận
Carefully	cẩn thận
Cargo	hàng hóa
Carpet	thảm
Carrier	vận chuyển
Carrot	cà rốt
Carry	mang
Cart	xe đẩy
Cartoon	hoạt hình
Carve	khắc chạm
Case	trường hợp
Cash	tiền mặt
Casino	sòng bạc
Cast	dàn diễn viên
Casual	giản dị
Casualty	tai nạn
Cat	con mèo
Catalog	mục lục
Catch	bắt lấy
Category	thể loại
Catholic	Công giáo
Cattle	gia súc
Cause	nguyên nhân
Cave	hang
Cease	ngưng
Ceiling	trần nhà
Celebrate	ăn mừng
Celebration	lễ kỷ niệm
Celebrity	người nổi tiếng
Cell	tế bào
Cemetery	Nghĩa trang
Center	Trung tâm
Central	Trung tâm
Century	thế kỷ
Ceo	CEO
Ceremony	Lễ
Certain	chắc chắn
Certainly	chắc chắn
Chain	chuỗi
Chair	cái ghế
Chairman	chủ tịch
Challenge	thử thách
Chamber	buồng
Champion	quán quân
Championship	chức vô địch
Chance	cơ hội
Change	thay đổi
Changing	thay đổi
Channel	kênh
Chaos	hỗn loạn
Chapter	chương
Character	tính cách
Characteristic	đặc trưng
Characterize	đặc trưng
Charge	sạc điện
Charity	từ thiện
Charm	quyến rũ
Chart	đồ thị
Charter	điều lệ
Chase	đuổi theo
Cheap	giá rẻ
Cheat	lừa đảo
Check	kiểm tra
Cheek	má
Cheer	vui lên
Cheese	phô mai
Chef	đầu bếp
Chemical	hóa chất
Chemistry	hóa học
Chest	ngực
Chew	nhai
Chicken	gà
Chief	giám đốc
Child	đứa trẻ
Childhood	thời thơ ấu
Chill	làm lạnh
Chin	cái cằm
Chinese	Trung Quốc
Chip	Chip
Chocolate	sô cô la
Choice	lựa chọn
Choose	chọn
Chop	chặt
Christianity	Cơ đốc giáo
Christmas	Giáng Sinh
Chronic	mãn tính
Chunk	mảnh
Church	nhà thờ
Cigarette	thuốc lá
Circle	vòng tròn
Circuit	mạch
Circumstance	tình huống
Cite	trích dẫn
Citizen	công dân
Citizenship	quyền công dân
City	thành phố
Civic	công dân
Civil	dân sự
Civilian	dân thường
Civilization	nền văn minh
Claim	yêu cầu
Class	lớp học
Classic	cổ điển
Classical	cổ điển
Classify	phân loại
Classroom	phòng học
Clay	đất sét
Clean	dọn dẹp
Clear	trong sáng
Clearly	thông suốt
Clerk	nhân viên bán hàng
Click	nhấp chuột
Client	khách hàng
Cliff	vách đá
Climate	khí hậu
Climb	leo
Cling	bám lấy
Clinic	phòng khám bệnh
Clinical	lâm sàng
Clip	kẹp
Clock	đồng hồ
Close	gần
Closed	đóng
Closely	chặt chẽ
Closer	gần hơn
Closest	gần nhất
Closet	tủ quần áo
Cloth	vải
Clothes	quần áo
Clothing	quần áo
Cloud	đám mây
Club	câu lạc bộ
Clue	manh mối
Cluster	cụm
Coach	huấn luyện viên
Coal	than
Coalition	liên minh
Coast	bờ biển
Coastal	duyên hải
Coat	áo khoác
Cocaine	cocaine
Code	mã
Coffee	cà phê
Cognitive	nhận thức
Coin	đồng tiền
Cold	lạnh
Collaboration	hợp tác
Collapse	sự sụp đổ
Collar	cổ áo
Colleague	đồng nghiệp
Collect	sưu tầm
Collection	bộ sưu tập
Collective	tập thể
Collector	người thu gom
College	trường đại học
Colonial	thuộc địa
Colony	thuộc địa
Color	màu
Colorful	Đầy màu sắc
Column	cột
Columnist	nhà bình luận viên
Combat	chống lại
Combination	sự phối hợp
Combine	phối hợp
Combined	kết hợp
Come	đến
Comedy	phim hài
Comfort	thoải mái
Comfortable	Thoải mái
Coming	đang đến
Command	chỉ huy
Commander	chỉ huy
Comment	bình luận
Commercial	thương mại
Commission	Uỷ ban
Commissioner	ủy viên
Commit	cam kết
Commitment	cam kết
Committee	ủy ban
Commodity	hàng hóa
Common	chung
Commonly	thông thường
Communicate	giao tiếp
Communication	giao tiếp
Community	cộng đồng
Companion	đồng hành
Company	Công ty
Comparable	so sánh
Compare	so sánh
Comparison	so sánh
Compel	bắt buộc
Compelling	thuyết phục
Compensation	đền bù
Compete	cạnh tranh
Competition	cuộc thi
Competitive	cạnh tranh
Competitor	đối thủ
Complain	than phiền
Complaint	lời phàn nàn
Complete	hoàn thành
Completely	hoàn toàn
Complex	phức tạp
Complexity	phức tạp
Compliance	sự tuân thủ
Complicated	phức tạp
Comply	tuân theo
Component	thành phần
Compose	soạn, biên soạn
Composition	thành phần
Compound	hợp chất
Comprehensive	toàn diện
Comprise	bao gồm
Compromise	thỏa hiệp
Computer	máy vi tính
Concede	công nhận
Conceive	thụ thai
Concentrate	tập trung
Concentration	sự tập trung
Concept	khái niệm
Conception	quan niệm
Concern	mối quan ngại
Concerned	liên quan
Concerning	có liên quan
Concert	buổi hòa nhạc
Conclude	kết luận
Conclusion	phần kết luận
Concrete	bê tông
Condemn	lên án
Condition	điều kiện
Conduct	hạnh kiểm
Conference	hội nghị
Confess	xưng
Confession	lời thú tội
Confidence	sự tự tin
Confident	tự tin
Confirm	xác nhận
Conflict	cuộc xung đột
Confront	đối đầu
Confrontation	đối đầu
Confuse	nhầm lẫn
Confusion	sự nhầm lẫn
Congress	Hội nghị
Congressional	quốc hội
Connect	kết nối
Connection	kết nối
Conscience	lương tâm
Conscious	có ý thức
Consciousness	ý thức
Consecutive	liên tiếp
Consensus	sự đồng thuận
Consent	bằng lòng
Consequence	hậu quả
Consequently	hậu quả là
Conservation	bảo tồn
Conservative	thận trọng
Consider	xem xét
Considerably	đáng kể
Consideration	xem xét
Consist	bao gồm
Consistent	thích hợp
Consistently	nhất quán
Conspiracy	âm mưu
Constant	không thay đổi
Constantly	liên tục
Constitute	cấu tạo
Constitution	hiến pháp
Constraint	hạn chế
Construct	xây dựng
Consult	tham khảo ý kiến
Consultant	tư vấn
Consume	tiêu dùng
Consumer	khách hàng
Consumption	tiêu dùng
Contact	tiếp xúc
Contain	chứa
Container	thùng đựng hàng
Contemplate	thưởng ngoạn
Contemporary	đồng thời
Contend	đấu tranh
Content	Nội dung
Contest	Cuộc thi
Context	bối cảnh
Continent	lục địa
Continue	tiếp tục
Continued	tiếp tục
Continuing	tiếp tục
Continuous	liên tiếp
Contract	hợp đồng
Contractor	nhà thầu
Contrast	tương phản
Contribute	Góp phần
Contribution	sự đóng góp
Contributor	người đóng góp
Control	điều khiển
Controversial	gây tranh cãi
Controversy	tranh cãi
Convenience	tiện
Convention	quy ước
Conventional	thông thường
Conversation	cuộc hội thoại
Conversion	chuyển đổi
Convert	đổi
Convey	chuyên chở
Convict	tù nhân
Conviction	lòng tin chắc, sự kết án, phán quyết
Convince	thuyết phục
Convinced	thuyết phục
Cook	nấu ăn
Cookie	bánh quy
Cooking	nấu nướng
Cool	mát mẻ
Cooperate	hợp tác
Cooperation	hợp tác
Cooperative	hợp tác xã
Coordinate	danh từ
Coordinator	điều phối viên
Cop	cảnh sát
Cope	đối phó
Copy	sao chép
Cord	dây
Core	cốt lõi
Corn	Ngô
Corner	góc
Corporate	công ty
Corporation	tập đoàn
Correct	chính xác
Correctly	đúng
Correlation	tương quan
Correspondent	phóng viên
Corridor	hành lang
Corruption	tham nhũng
Cost	Giá cả
Costly	tốn kém
Costume	trang phục
Cottage	nhà tranh
Cotton	bông
Couch	đi văng
Could	có thể
Council	hội đồng
Counsel	lời khuyên
Counseling	tư vấn
Counselor	cố vấn
Count	đếm
Counter	quầy tính tiền
Counterpart	đối tác
Country	Quốc gia
County	quận
Coup	cuộc đảo chính
Couple	vợ chồng
Courage	lòng can đảm
Course	khóa học
Court	tòa án
Courtroom	phòng xử án
Cousin	anh chị em họ
Cover	che
Coverage	phủ sóng
Cow	bò
Crack	bẻ khóa
Craft	nghề thủ công
Crash	tai nạn
Crawl	thu thập thông tin
Crazy	khùng
Cream	kem
Create	tạo nên
Creation	sự sáng tạo
Creative	sáng tạo
Creativity	sáng tạo
Creature	sinh vật
Credibility	uy tín
Credit	tín dụng
Crew	phi hành đoàn
Crime	tội ác
Criminal	phạm tội
Crisis	khủng hoảng
Criteria	tiêu chuẩn
Critic	nhà phê bình
Critical	chỉ trích
Criticism	sự chỉ trích
Criticize	chỉ trích
Crop	mùa vụ
Cross	vượt qua
Crowd	đám đông
Crowded	Đông người
Crucial	quan trọng
Cruel	hung ác
Cruise	du lịch
Crush	nghiền nát
Cry	khóc
Crystal	pha lê
Cuban	Cuba
Cue	gợi ý
Cultural	văn hoá
Culture	nền văn hóa
Cup	tách
Cure	chữa khỏi
Curiosity	sự tò mò
Curious	hiếu kỳ
Currency	tiền tệ
Current	hiện hành
Currently	hiện tại
Curriculum	chương trình giáo dục
Curtain	tấm màn
Curve	đường cong
Custody	quyền nuôi con
Custom	tập quán
Customer	khách hàng
Cut	cắt tỉa
Cute	dễ thương
Cycle	chu kỳ
Dad	cha
Daily	hằng ngày
Dam	con đập
Damage	hư hại
Damn	chỉ trích
Dance	nhảy
Dancer	vũ công
Dancing	khiêu vũ
Danger	nguy hiểm
Dangerous	nguy hiểm
Dare	dám
Dark	tối
Darkness	bóng tối
Data	dữ liệu
Database	cơ sở dữ liệu
Date	ngày
Daughter	Con gái
Dawn	bình minh
Day	ngày
Dead	đã chết
Deadline	hạn chót
Deadly	chết người
Deal	thỏa thuận
Dealer	người buôn bán
Dear	kính thưa
Death	tử vong
Debate	tranh luận
Debris	mảnh vụn
Debt	món nợ
Debut	ra mắt
Decade	thập kỷ
Decent	phong nha
Decide	quyết định
Decision	phán quyết
Deck	boong
Declare	khai
Decline	từ chối
Decorate	trang trí
Decrease	giảm bớt
Dedicate	dâng hiến
Deem	thấy
Deep	sâu
Deeply	sâu sắc
Deer	con nai
Defeat	đánh bại
Defend	phòng thủ
Defendant	bị cáo
Defender	hậu vệ
Defense	phòng thủ
Defensive	phòng ngự
Deficit	thâm hụt
Define	định nghĩa
Definitely	chắc chắn
Definition	Định nghĩa
Degree	trình độ
Delay	sự chậm trễ
Deliberately	thong thả
Delicate	tinh tế
Delight	Hân hoan
Deliver	giao hàng
Delivery	chuyển
Demand	nhu cầu
Democracy	dân chủ
Democrat	Dân chủ
Democratic	dân chủ
Demographic	nhân khẩu học
Demonstrate	chứng minh
Demonstration	trình diễn
Denial	từ chối
Dense	dày đặc
Density	tỉ trọng
Deny	phủ nhận
Depart	khởi hành
Department	bộ phận
Departure	khởi hành
Depend	tùy theo
Dependent	phụ thuộc
Depending	tùy
Depict	miêu tả
Deploy	triển khai
Deposit	tiền gửi
Depressed	suy sụp
Depression	Phiền muộn
Depth	chiều sâu
Deputy	Phó
Derive	lấy được
Descend	hạ xuống
Describe	miêu tả
Description	sự miêu tả
Desert	Sa mạc
Deserve	xứng đáng
Design	thiết kế
Designer	nhà thiết kế
Desire	khao khát
Desk	bàn
Desperate	tuyệt vọng
Desperately	tuyệt vọng
Despite	mặc dù
Dessert	món tráng miệng
Destination	nơi đến
Destroy	hủy hoại
Destruction	sự phá hủy
Detail	chi tiết
Detailed	chi tiết
Detect	phát hiện
Detective	thám tử
Determination	sự quyết tâm
Determine	mục đích
Devastating	tàn phá
Develop	phát triển, xây dựng
Developer	nhà phát triển
Developing	phát triển
Development	phát triển
Developmental	phát triển
Device	thiết bị
Devil	ác quỷ
Devote	cống hiến
Diabetes	Bệnh tiểu đường
Diagnose	chẩn đoán
Diagnosis	chẩn đoán
Dialogue	đối thoại
Diamond	kim cương
Diary	Nhật ký
Dictate	điều khiển
Die	chết
Diet	chế độ ăn
Differ	khác nhau
Difference	Sự khác biệt
Different	khác nhau
Differently	khác
Difficult	khó khăn
Difficulty	khó khăn
Dig	đào
Digital	kỹ thuật số
Dignity	phẩm giá
Dilemma	tình trạng khó xử
Dimension	kích thước
Diminish	suy giảm
Dining	ăn uống
Dinner	bữa tối
Dip	nhúng
Diplomat	nhà ngoại giao
Diplomatic	ngoại giao
Direct	thẳng thắn
Direction	phương hướng
Directly	trực tiếp
Director	giám đốc
Dirt	bẩn
Dirty	dơ bẩn
Disability	khuyết tật
Disabled	tàn tật
Disagree	không đồng ý
Disappear	biến mất
Disappointed	thất vọng
Disappointment	thất vọng
Disaster	thảm họa
Disc	đĩa
Discipline	kỷ luật
Disclose	tiết lộ
Discount	giảm giá
Discourage	gây chán nản cho
Discourse	đàm luận
Discover	khám phá
Discovery	khám phá
Discrimination	kỳ thị
Discuss	bàn luận
Discussion	thảo luận
Disease	dịch bệnh
Dish	món ăn
Disk	đĩa
Dismiss	bỏ qua
Disorder	rối loạn
Display	trưng bày
Dispute	tranh chấp
Dissolve	giải thể
Distance	khoảng cách
Distant	xa xôi
Distinct	khác biệt
Distinction	phân biệt
Distinctive	đặc biệt
Distinguish	phân biệt
Distract	làm mất tập trung
Distribute	phân phát
Distribution	phân phối
District	huyện
Disturb	xáo trộn
Disturbing	phiền
Diverse	phong phú
Diversity	sự đa dạng
Divide	chia
Divine	thần thánh
Division	phân chia
Divorce	ly hôn
Dna	DNA
Do	làm
Dock	bến tàu
Doctor	Bác sĩ
Doctrine	học thuyết
Document	tài liệu
Documentary	phim tài liệu
Dog	chó
Doll	búp bê
Domain	miền
Domestic	trong nước
Dominant	có ưu thế
Dominate	thống trị
Donate	hiến tặng
Donation	Quyên góp
Donor	nhà tài trợ
Door	cửa
Doorway	lối vào
Dose	liều
Dot	dấu chấm
Double	gấp đôi
Doubt	nghi ngờ
Dough	bột
Down	xuống
Downtown	trung tâm thành phố
Dozen	tá
Draft	bản nháp
Drag	kéo
Drain	ráo nước
Drama	kịch
Dramatic	kịch tính
Dramatically	đột ngột
Draw	vẽ tranh
Drawer	ngăn kéo
Drawing	vẽ
Dream	mơ tưởng
Dress	trang phục
Dried	khô
Drift	trôi dạt
Drill	máy khoan
Drink	uống
Drinking	uống
Drive	lái xe
Driver	người lái xe
Driveway	đường lái xe
Driving	điều khiển
Drop	rơi vãi
Drown	chết chìm
Drug	thuốc uống
Drum	trống
Drunk	say
Dry	khô
Duck	con vịt
Due	đến hạn
Dumb	ngớ ngẩn
Dump	đổ
During	suốt trong
Dust	bụi bặm
Dutch	Người Hà Lan
Duty	nhiệm vụ
Dying	chết
Dynamic	năng động
Dynamics	động lực học
Each	mỗi
Eager	hăng hái
Ear	tai
Early	sớm
Earn	kiếm
Earnings	thu nhập
Earth	trái đất
Earthquake	động đất
Ease	giảm bớt
Easily	dễ dàng
East	Đông
Eastern	phương Đông
Easy	dễ dàng
Eat	ăn
Eating	Ăn
Echo	echo
Ecological	sinh thái
Economic	thuộc kinh tế
Economically	kinh tế
Economics	Kinh tế học
Economist	nhà kinh tế học
Economy	nên kinh tê
Ecosystem	hệ sinh thái
Edge	cạnh
Edit	chỉnh sửa
Edition	phiên bản
Editor	người biên tập
Educate	giáo dục
Education	giáo dục
Educational	giáo dục
Educator	nhà giáo dục
Effect	hiệu ứng
Effective	có hiệu lực
Effectively	có hiệu quả
Effectiveness	hiệu quả
Efficiency	hiệu quả
Efficient	hiệu quả
Effort	cố gắng
Egg	trứng
Ego	tự ngã
Eight	tám
Eighth	thứ tám
Either	hoặc
Elaborate	kỹ lưỡng
Elbow	khuỷu tay
Elder	đàn anh
Elderly	người lớn tuổi
Elect	trúng tuyển
Election	cuộc bầu cử
Electric	điện
Electrical	điện
Electricity	điện
Electronic	điện tử
Electronics	thiết bị điện tử
Elegant	thanh lịch
Element	thành phần
Elementary	tiểu học
Elephant	con voi
Elevator	thang máy
Eleven	mười một
Eligible	hội đủ điều kiện
Eliminate	loại bỏ
Elite	ưu tú
Else	khác
Elsewhere	ở nơi khác
Embarrassed	xấu hổ
Embrace	ôm hôn
Emerge	hiện ra
Emergency	trường hợp khẩn cấp
Emerging	mới nổi
Emission	khí thải
Emotion	cảm xúc
Emotional	đa cảm
Emotionally	tình cảm
Emphasis	nhấn mạnh
Emphasize	nhấn mạnh
Empire	đế chế
Employ	thuê
Employee	Nhân viên
Employer	nhà tuyển dụng
Employment	việc làm
Empty	trống
Enable	cho phép
Enact	ban hành
Encounter	gặp gỡ
Encourage	khuyến khích
Encouraging	khuyến khích
End	kết thúc
Endless	bất tận
Endorse	chứng thực
Endure	chịu đựng
Enemy	kẻ thù
Energy	năng lượng
Enforce	thi hành
Enforcement	thực thi
Engage	thuê
Engagement	hôn ước
Engine	động cơ
Engineer	kỹ sư
Engineering	kỹ thuật
English	tiếng Anh
Enhance	nâng cao
Enjoy	thưởng thức
Enormous	to lớn
Enough	đủ
Enroll	ghi danh
Ensure	đảm bảo
Enter	đi vào
Enterprise	doanh nghiệp
Entertainment	sự giải trí
Enthusiasm	hăng hái
Entire	toàn bộ
Entirely	hoàn toàn
Entitle	quyền lợi
Entity	thực thể
Entrance	cổng vào
Entrepreneur	doanh nhân
Entry	nhập cảnh
Envelope	phong bì
Environment	môi trường
Environmental	môi trường
Envision	hình dung
Epidemic	bệnh dịch
Episode	tập phim
Equal	công bằng
Equality	bình đẳng
Equally	bằng nhau
Equation	phương trình
Equip	Trang bị
Equipment	Trang thiết bị
Equity	công bằng
Equivalent	tương đương
Era	kỷ nguyên
Error	lỗi
Escape	thoát khỏi
Especially	đặc biệt
Essay	tiểu luận
Essence	Bản chất
Essential	Cần thiết
Essentially	bản chất
Establish	thành lập
Establishment	thành lập
Estate	bất động sản
Estimate	ước tính
Estimated	ước tính
Etc	vv
Ethical	đạo đức
Ethics	đạo đức
Ethnic	dân tộc
European	Châu Âu
Evaluate	đánh giá
Evaluation	đánh giá
Even	cũng
Evening	tối
Event	biến cố
Eventually	cuối cùng
Ever	không bao giờ
Every	mỗi
Everybody	mọi người
Everyday	mỗi ngày
Everyone	tất cả mọi người
Everything	mọi điều
Everywhere	mọi nơi
Evidence	chứng cớ
Evident	hiển nhiên
Evil	tà ác
Evolution	sự phát triển
Evolve	phát triển
Exact	chính xác
Exactly	chính xác
Exam	thi
Examination	kiểm tra
Examine	xem xét
Example	thí dụ
Exceed	quá
Excellent	Xuất sắc
Except	ngoại trừ
Exception	ngoại lệ
Excessive	quá đáng
Exchange	trao đổi, giao dịch
Excited	bị kích thích
Excitement	sự phấn khích
Exciting	thú vị
Exclude	loại trừ
Exclusive	độc quyền
Exclusively	duy nhất
Excuse	tha
Execute	thi hành
Execution	chấp hành
Executive	điều hành
Exercise	tập thể dục
Exhaust	thoát ra
Exhibit	triển lãm
Exhibition	triển lãm
Exist	hiện hữu
Existence	sự tồn tại
Existing	hiện tại
Exit	lối thoát
Exotic	kỳ lạ
Expand	mở rộng
Expansion	sự bành trướng
Expect	chờ đợi
Expectation	sự mong đợi
Expected	kỳ vọng
Expedition	thám hiểm
Expense	chi phí
Expensive	đắt
Experience	kinh nghiệm
Experienced	có kinh nghiệm
Experiment	thí nghiệm
Experimental	thử nghiệm
Expert	chuyên gia
Expertise	chuyên môn
Explain	giải thích
Explanation	giải trình
Explicit	rõ ràng
Explo de	nổ tung
Exploit	khai thác
Exploration	thăm dò
Explore	khám phá
Explosion	nổ
Export	xuất khẩu
Expose	lộ ra
Exposure	Phơi bày
Express	bày tỏ
Expression	biểu hiện
Extend	mở rộng
Extended	mở rộng
Extension	sự mở rộng
Extensive	sâu rộng
Extent	phạm vi
External	bên ngoài
Extra	thêm
Extraordinary	bất thường
Extreme	cực
Extremely	vô cùng
Eye	mắt
Eyebrow	lông mày
Fabric	vải
Face	khuôn mặt ,đối mặt
Facilitate	tạo điều kiện
Facility	cơ sở
Fact	thực tế
Factor	hệ số
Factory	nhà máy
Faculty	giảng viên
Fade	phai màu
Fail	Thất bại
Failure	thất bại
Faint	mờ nhạt
Fair	hội chợ
Fairly	công bằng
Faith	đức tin
Fall	ngã
False	sai
Fame	danh tiếng
Familiar	quen
Family	gia đình
Famous	nổi danh
Fan	quạt
Fantastic	tuyệt diệu
Fantasy	tưởng tượng
Far	xa
Fare	giá vé
Farm	nông trại
Farmer	nông phu
Fascinating	hấp dẫn
Fashion	thời trang
Fast	Nhanh
Faster	nhanh hơn
Fat	mập
Fatal	gây tử vong
Fate	số phận
Father	cha
Fatigue	mệt mỏi
Fault	lỗi
Favor	ủng hộ
Favorable	thuận lợi
Favorite	yêu thích
Fear	nỗi sợ
Feather	lông vũ
Feature	đặc tính
Federal	liên bang
Fee	chi phí
Feed	nuôi
Feedback	Phản hồi
Feel	cảm thấy
Feeling	cảm giác
Fellow	đồng bào
Female	giống cái
Feminist	nữ quyền sĩ
Fence	hàng rào
Festival	lễ hội
Fever	sốt
Few	vài
Fewer	ít hơn
Fiber	chất xơ
Fiction	viễn tưởng
Field	cánh đồng
Fierce	khốc liệt
Fifteen	mười lăm
Fifth	thứ năm
Fifty	năm mươi
Fight	chiến đấu
Fighter	đấu sĩ
Fighting	trận đánh
Figure	nhân vật
File	tập tin
Fill	lấp đầy
Film	phim ảnh
Filter	lọc
Final	sau cùng
Finally	cuối cùng
Finance	tài chính
Financial	tài chính
Find	tìm thấy
Finding	Phát hiện
Fine	khỏe
Finger	ngón tay
Finish	hoàn thành
Fire	ngọn lửa
Firm	chắc chắn
Firmly	vững chắc
First	Đầu tiên
Fiscal	tài chính
Fish	cá
Fisherman	ngư dân
Fishing	đánh bắt cá
Fist	nắm tay
Fit	Phù hợp
Fitness	sự tập thể dục
Five	số năm
Fix	sửa chữa
Fixed	đã sửa
Flag	cờ
Flame	ngọn lửa
Flash	đèn flash
Flat	bằng phẳng
Flavor	hương vị
Flee	chạy trốn
Fleet	hạm đội
Flesh	xác thịt
Flexibility	Mềm dẻo
Flexible	linh hoạt
Flight	chuyến bay
Flip	lật
Float	phao
Flood	lũ
Floor	sàn nhà
Flour	bột mì
Flow	lưu lượng
Flower	hoa
Fluid	chất lỏng
Fly	bay
Flying	bay
Focus	tiêu điểm
Fog	sương mù
Fold	gập lại
Folk	dân gian
Follow	theo
Following	tiếp theo
Food	món ăn
Fool	ngu xuẩn
Foot	chân
Football	bóng đá
For	cho
Forbid	ngăn cấm
Force	lực lượng
Forehead	trán
Foreign	ngoại quốc
Foreigner	người nước ngoài
Forest	rừng
Forever	mãi mãi
Forget	quên
Forgive	tha lỗi
Fork	cái nĩa
Form	hình thức
Formal	chính thức
Format	định dạng
Formation	sự hình thành
Former	trước đây
Formerly	trước kia
Formula	công thức
Forth	ra
Fortunately	may mắn
Fortune	vận may
Forty	bốn mươi
Forum	diễn đàn
Forward	phía trước
Foster	nuôi dưỡng
Found	tìm
Foundation	nền tảng
Founder	người sáng lập
Four	bốn
Fourth	thứ tư
Fraction	phân số
Fragile	mong manh
Fragment	miếng
Frame	khung
Framework	khuôn khổ
Franchise	nhượng quyền thương mại
Frankly	thẳng thắn
Fraud	gian lận
Free	miễn phí
Freedom	sự tự do
Freely	tự do
Freeze	Đông cứng
French	người Pháp
Frequency	tần số
Frequent	Thường xuyên
Frequently	thường xuyên
Fresh	tươi
Freshman	sinh viên năm nhất
Friend	người bạn
Friendly	thân thiện
Friendship	hữu nghị
From	từ
Front	trước mặt
Frontier	biên giới
Frown	nhăn mặt
Frozen	đông lạnh
Fruit	trái cây
Frustrate	thất vọng
Fucking	fucking
Fuel	nhiên liệu
Full	đầy
Full-time	toàn thời gian
Fully	đầy đủ
Fun	vui vẻ
Function	chức năng, hàm
Functional	chức năng
Fund	quỹ
Fundamental	căn bản
Funding	kinh phí
Funeral	tang lễ
Funny	buồn cười
Fur	lông thú
Furniture	đồ nội thất
Furthermore	hơn nữa
Future	Tương lai
Gain	thu được
Galaxy	Thiên hà
Gallery	bộ sưu tập
Game	trò chơi
Gang	băng nhóm
Gap	lỗ hổng
Garage	gara
Garbage	rác thải
Garden	vườn
Garlic	tỏi
Gas	khí đốt
Gasoline	xăng
Gate	cánh cổng
Gather	tụ họp
Gathering	thu thập
Gay	gay
Gaze	nhìn chằm chằm
Gear	Hộp số
Gender	giới tính
Gene	gen
General	chung
Generally	nói chung là
Generate	tạo ra
Generation	thế hệ
Generous	hào phóng
Genetic	di truyền
Genius	Thiên tài
Genre	thể loại
Gentle	dịu dàng
Gentleman	quý ông
Gently	dịu dàng
Genuine	chính hãng
German	tiếng Đức
Gesture	cử chỉ
Get	được
Ghost	ma
Giant	khổng lồ
Gift	quà tặng
Gifted	năng khiếu
Girl	con gái
Girlfriend	bạn gái
Give	đưa cho
Given	được
Glad	vui vẻ
Glance	nháy mắt
Glass	ly
Glimpse	nhìn thoáng qua
Global	toàn cầu
Globe	quả địa cầu
Glory	vinh quang
Glove	găng tay
Go	đi
Goal	mục tiêu
Goat	con dê
God	thần
Gold	vàng
Golden	vàng
Golf	golf
Good	tốt
Govern	quản lý
Government	chính quyền
Governor	thống đốc
Grab	vồ lấy
Grace	ân sủng
Grade	cấp
Gradually	dần dần
Graduate	tốt nghiệp
Graduation	tốt nghiệp
Grain	ngũ cốc
Grand	lớn
Grandchild	cháu ngoại
Grandfather	ông nội
Grandmother	bà ngoại
Grandparent	ông bà
Grant	ban cho
Grape	giống nho
Grasp	sự hiểu biết
Grass	cỏ
Grateful	tri ân
Grave	phần mộ
Gravity	nghiêm trọng
Gray	màu xám
Great	tuyệt quá
Greatest	vĩ đại nhất
Greatly	rất nhiều
Greek	người Hy Lạp
Green	màu xanh lá
Greet	chào hỏi
Grief	đau buồn
Grin	nụ cười
Grip	nắm chặt
Grocery	tạp hóa
Gross	Tổng
Ground	đất
Group	nhóm
Grow	lớn lên
Growing	phát triển
Growth	sự phát triển
Guarantee	Bảo hành
Guard	bảo vệ
Guess	phỏng đoán
Guest	khách
Guidance	hướng dẫn
Guide	hướng dẫn
Guideline	hướng dẫn
Guilt	tội lỗi
Guilty	tội lỗi
Guitar	đàn ghi ta
Gun	súng
Gut	ruột
Guy	chàng
Gym	phòng thể dục
Ha	ha
Habit	thói quen
Habitat	môi trường sống
Hair	tóc
Half	một nửa
Halfway	nửa chừng
Hall	đại sảnh
Hallway	hành lang
Hand	tay
Handful	ít
Handle	xử lý
Handsome	đẹp
Hang	treo
Happen	xảy ra
Happily	hạnh phúc
Happiness	hạnh phúc
Happy	vui mừng
Harassment	quấy rối
Hard	cứng
Hardly	khó khăn
Hardware	phần cứng
Harm	làm hại
Harmony	hòa hợp
Harsh	khắc nghiệt
Harvest	mùa gặt
Hat	nón
Hate	ghét bỏ
Haul	lôi
Have	có
Hazard	nguy hiểm
He	anh ta
Head	cái đầu
Headache	đau đầu
Headline	tiêu đề
Headquarters	trụ sở chính
Heal	chữa lành
Health	Sức khỏe
Healthy	khỏe mạnh
Hear	Nghe
Hearing	thính giác
Heart	tim
Heat	nhiệt
Heaven	thiên đường
Heavily	nặng nề
Heavy	nặng
Heel	gót chân
Height	Chiều cao
Helicopter	máy bay trực thăng
Hell	Địa ngục
Hello	xin chào
Helmet	mũ bảo hiểm
Help	Cứu giúp
Helpful	Hữu ích
Hence	vì thế
Her	cô ấy
Herb	thảo mộc
Here	đây
Heritage	gia tài
Hero	anh hùng
Hers	của cô ấy
Herself	cô ấy
Hesitate	do dự
Hey	Chào
Hi	Chào
Hidden	ẩn
Hide	ẩn giấu
High	cao
High-tech	công nghệ cao
Highlight	Điểm nổi bật
Highly	cao
Highway	Xa lộ
Hike	đi lang thang
Hill	đồi núi
Him	anh ta
Himself	bản thân anh ấy
Hint	dấu
Hip	hông
Hire	thuê mướn
His	của anh ấy
Hispanic	Người Hispanic
Historian	nhà sử học
Historic	mang tính lịch sử
Historical	lịch sử
History	lịch sử
Hit	đánh
Hockey	khúc côn cầu
Hold	giữ
Hole	lỗ
Holiday	ngày lễ
Holy	thánh
Home	nhà
Homeland	quê hương
Homeless	Vô gia cư
Homework	bài tập về nhà
Honest	thật thà
Honestly	thành thật
Honey	mật ong
Honor	tôn vinh
Hook	cái móc
Hope	mong
Hopefully	hy vọng
Horizon	đường chân trời
Hormone	hoocmon
Horn	sừng
Horrible	kinh khủng
Horror	kinh dị
Horse	con ngựa
Hospital	bệnh viện
Host	chủ nhà
Hostage	con tin
Hostile	Hostile
Hot	nóng bức
Hotel	khách sạn
Hour	giờ
House	nhà ở
Household	hộ gia đình
Housing	nhà ở
How	làm sao
However	Tuy nhiên
Hp	hãng máy tính hp
Hug	ôm
Huge	khổng lồ
Huh	Huh
Human	Nhân loại
Humanity	nhân loại
Humor	hài hước
Hundred	hàng trăm
Hunger	đói
Hungry	đói bụng
Hunt	săn bắn
Hunter	thợ săn
Hunting	săn bắn
Hurricane	bão
Hurry	vội
Hurt	đau
Husband	người chồng
Hypothesis	giả thuyết
I	tôi
Ice	Nước đá
Icon	biểu tượng
Idea	ý kiến
Ideal	lý tưởng
Identical	giống nhau
Identification	nhận biết
Identify	nhận định
Ideological	ý thức hệ
Ideology	hệ tư tưởng
Ie	nghĩa là
If	nếu
Ignore	bỏ qua
Ill	bệnh
Illegal	bất hợp pháp
Illness	bệnh
Illusion	ảo giác
Illustrate	Minh họa
Image	hình ảnh
Imagination	trí tưởng tượng
Imagine	tưởng tượng
Immediate	ngay lập tức
Immediately	ngay
Immigrant	di trú
Immigration	nhập cư
Immune	miễn dịch
Impact	va chạm
Implement	thực hiện
Implementation	thực hiện
Implication	hàm ý
Imply	ngụ ý
Import	nhập khẩu
Importance	tầm quan trọng
Important	quan trọng
Importantly	quan trọng
Impose	áp đặt
Impossible	Không thể nào
Impress	gây ấn tượng
Impression	ấn tượng
Impressive	ấn tượng
Improve	cải tiến
Improved	cải tiến
Improvement	cải tiến
Impulse	thúc đẩy
In	trong
Incentive	khuyến khích
Incident	biến cố
Include	bao gồm
Including	kể cả
Income	thu nhập
Incorporate	kết hợp
Increase	tăng
Increased	tăng
Increasing	tăng
Increasingly	ngày càng
Incredible	đáng kinh ngạc
Incredibly	vô cùng
Indeed	thật
Independence	độc lập
Independent	độc lập
Index	mục lục
Indian	người Ấn Độ
Indicate	biểu thị
Indication	dấu hiệu
Indicator	chỉ thị
Indigenous	bản địa
Individual	cá nhân
Industrial	công nghiệp
Industry	ngành công nghiệp
Inevitable	chắc chắn xảy ra
Inevitably	chắc chắn
Infant	trẻ sơ sinh
Infection	nhiễm trùng
Inflation	lạm phát
Influence	ảnh hưởng
Influential	có ảnh hưởng
Inform	thông báo
Informal	không chính thức
Information	thông tin
Infrastructure	cơ sở hạ tầng
Ingredient	thành phần
Inherent	vốn có
Inherit	thừa kế
Initial	ban đầu
Initially	ban đầu
Initiate	bắt đầu
Initiative	sáng kiến
Injure	làm bị thương
Injury	chấn thương
Inmate	tù nhân
Inner	bên trong
Innocent	vô tội
Innovation	đổi mới
Innovative	sáng tạo
Input	đầu vào
Inquiry	yêu cầu
Insect	côn trùng
Insert	chèn
Inside	phía trong
Insight	cái nhìn sâu sắc
Insist	năn nỉ
Inspection	kiểm tra
Inspector	thanh tra
Inspiration	cảm hứng
Inspire	truyền cảm hứng
Install	cài đặt, dựng lên
Installation	cài đặt
Instance	ví dụ
Instant	tức thời
Instantly	ngay lập tức
Instead	thay thế
Instinct	bản năng
Institution	tổ chức
Institutional	thể chế
Instruct	dạy
Instruction	chỉ dẫn
Instructional	hướng dẫn
Instructor	giảng viên
Instrument	dụng cụ
Insurance	bảo hiểm
Intact	nguyên vẹn
Integrate	tích hợp
Integrated	tích hợp
Integration	hội nhập
Integrity	chính trực
Intellectual	trí tuệ
Intelligence	Sự thông minh
Intelligent	thông minh
Intend	dự định
Intense	cường độ cao
Intensity	cường độ
Intent	ý định
Intention	ý định
Interact	tương tác
Interaction	sự tương tác
Interest	quan tâm
Interested	quan tâm
Interesting	hấp dẫn
Interfere	gây trở ngại
Interior	Nội địa
Internal	bên trong
International	quốc tế
Internet	Internet
Interpret	thông dịch
Interpretation	diễn dịch
Interrupt	làm gián đoạn
Interval	khoảng thời gian
Intervention	can thiệp
Interview	phỏng vấn
Intimate	thân mật
Into	vào
Introduce	giới thiệu
Introduction	Giới thiệu
Invade	xâm chiếm
Invasion	cuộc xâm lăng
Invent	phát minh
Invention	sự phát minh
Inventory	hàng tồn kho
Invest	đầu tư
Investigate	điều tra
Investigation	cuộc điều tra
Investigator	điều tra viên
Investment	đầu tư
Investor	nhà đầu tư
Invisible	vô hình
Invitation	lời mời
Invite	mời gọi
Involve	liên quan
Involved	có tính liên quan
Involvement	sự tham gia
Iraqi	Iraqi
Irish	Người Ailen
Iron	bàn là
Ironically	trớ trêu thay
Irony	mỉa mai
Islam	đạo Hồi
Islamic	Hồi giáo
Island	Đảo
Isolate	cô lập
Isolated	bị cô lập
Isolation	cô lập
Israeli	Israeli
Issue	vấn đề
It	nó
Italian	người Ý
Item	mục
Its	của nó
Itself	chinh no
Jacket	Áo khoác
Jail	nhà giam
Japanese	tiếng Nhật
Jar	lọ
Jaw	hàm
Jazz	jazz
Jeans	Quần jean
Jet	máy bay phản lực
Jew	Người Do Thái
Jewelry	đồ trang sức
Jewish	Người Do thái
Job	việc làm
Join	tham gia
Joint	chung
Joke	đùa
Journal	tạp chí
Journalism	báo chí
Journalist	nhà báo
Journey	hành trình
Joy	vui sướng
Judge	thẩm phán
Judgment	phán đoán
Judicial	tư pháp
Juice	Nước ép
Jump	nhảy
Jungle	rừng nhiệt đới
Junior	em
Jurisdiction	quyền hạn
Juror	bồi thẩm đoàn
Jury	ban bồi thẩm
Just	chỉ
Justice	Sự công bằng
Justify	biện hộ
Keep	giữ
Key	Chìa khóa
Kick	đá
Kid	đứa trẻ
Kill	giết chết
Killer	sát thủ
Killing	giết chết
Kind	loại
King	nhà vua
Kingdom	Vương quốc
Kiss	hôn
Kit	bộ dụng cụ
Kitchen	phòng bếp
Knee	đầu gối
Kneel	quỳ xuống
Knife	dao
Knock	đánh
Know	biết
Knowledge	hiểu biết
Known	nổi tiếng
Korean	Hàn Quốc
Lab	phòng thí nghiệm
Label	nhãn
Labor	lao động
Laboratory	phòng thí nghiệm
Lack	thiếu sót
Ladder	thang
Lady	quý bà
Lake	hồ
Lamp	đèn
Land	đất đai
Landing	đổ bộ
Landmark	mốc
Landscape	phong cảnh
Lane	lane
Language	ngôn ngữ
Lap	vòng
Large	lớn
Largely	phần lớn
Laser	laser
Last	Cuối cùng
Late	muộn
Lately	gần đây
Later	một lát sau
Latin	Latin
Latter	sau này
Laugh	cười
Laughter	tiếng cười
Launch	phóng
Laundry	giặt ủi
Law	pháp luật
Lawmaker	nhà lập pháp
Lawn	bãi cỏ
Lawsuit	kiện tụng
Lawyer	luật sư
Lay	đặt nằm
Layer	lớp
Lead	chì
Leader	lãnh đạo
Leadership	khả năng lãnh đạo
Leading	dẫn đầu
Leaf	lá
League	liên đoàn
Lean	nạc
Leap	nhảy vọt
Learn	học hỏi
Learning	học tập
Least	ít nhất
Leather	da
Leave	rời khỏi
Lecture	bài học
Left	trái
Leg	Chân
Legacy	di sản
Legal	hợp pháp
Legally	hợp pháp
Legend	huyền thoại
Legislation	pháp luật
Legislative	lập pháp
Legislator	nhà lập pháp
Legislature	cơ quan lập pháp
Legitimate	hợp pháp
Lemon	Chanh
Lend	cho vay
Length	chiều dài
Lens	ống kính
Less	ít hơn
Lesson	bài học
Let	để cho
Letter	lá thư
Level	cấp độ
Liability	trách nhiệm pháp lý
Liberal	tự do
Liberty	tự do
Library	thư viện
License	giấy phép
Lid	Nắp
Lie	nói dối
Life	đời sống
Lifestyle	lối sống
Lifetime	cả đời
Lift	thang máy
Light	ánh sáng
Lighting	thắp sáng
Lightly	nhẹ nhàng
Lightning	sét đánh
Like	như
Likelihood	khả năng
Likely	có khả năng
Likewise	tương tự
Limb	chân tay
Limit	giới hạn
Limitation	giới hạn
Limited	giới hạn
Line	hàng
Link	liên kết
Lion	sư tử
Lip	môi
Liquid	chất lỏng
List	danh sách
Listen	nghe
Listener	người nghe
Literally	nghĩa đen
Literary	văn chương
Literature	văn chương
Little	một ít
Live	trực tiếp
Liver	Gan
Living	sống
Load	tải trọng
Loan	tiền vay
Lobby	sảnh đợi
Local	địa phương
Locate	định vị
Location	vị trí
Lock	Khóa
Log	đăng nhập
Logic	logic
Logical	hợp lý
Lonely	cô đơn
Long	Dài
Long-term	dài hạn
Longtime	thời gian dài
Look	nhìn
Loop	vòng lặp
Loose	lỏng lẻo
Lose	thua
Loss	mất mát
Lost	mất đi
Lot	nhiều
Lots	rất nhiều
Loud	to tiếng
Love	yêu
Lovely	đáng yêu
Lover	người yêu
Low	thấp
Lower	thấp hơn
Loyal	trung thành
Loyalty	lòng trung thành
Luck	may mắn
Lucky	may mắn
Lunch	Bữa trưa
Lung	phổi
Machine	máy móc
Mad	điên
Magazine	tạp chí
Magic	ma thuật
Magnetic	từ tính
Magnitude	độ lớn
Mail	thư
Main	chủ yếu
Mainly	chủ yếu
Mainstream	dòng chính
Maintain	duy trì
Maintenance	bảo trì
Major	chính
Majority	đa số
Make	chế tạo
Maker	nhà sản xuất
Makeup	trang điểm
Male	Nam giới
Mall	trung tâm mua sắm
Man	Đàn ông
Manage	quản lý
Management	sự quản lý
Manager	giám đốc
Managing	quản lý
Mandate	ủy nhiệm
Manipulate	vận dụng
Manner	cách thức
Mansion	biệt thự
Manual	sổ tay
Manufacturer	nhà chế tạo
Manufacturing	chế tạo
Many	nhiều
Map	bản đồ
Marble	đá hoa
March	tháng Ba
Margin	lề
Marine	biển
Mark	dấu
Marker	đánh dấu
Market	thị trường
Marketing	tiếp thị
Marketplace	thương trường
Marriage	kết hôn
Married	cưới nhau
Marry	kết hôn
Mask	mặt nạ
Mass	khối lượng
Massive	to lớn
Master	bậc thầy
Match	trận đấu
Mate	người bạn đời
Material	vật chất
Math	môn Toán
Mathematics	toán học
Matter	vấn đề
Maximum	tối đa
May	Tháng Năm
Maybe	có lẽ
Mayor	thị trưởng
Me	tôi
Meal	bữa ăn
Mean	nghĩa là
Meaning	Ý nghĩa
Meaningful	có ý nghĩa
Means (pl)	nghĩa là (PL)
Meantime	thời gian chờ đợi
Meanwhile	trong khi đó
Measure	đo
Measurement	phép đo
Meat	thịt
Mechanic	thợ cơ khí
Mechanical	cơ khí
Mechanism	cơ chế
Medal	huy chương
Media	phương tiện truyền thông
Medical	Y khoa
Medication	thuốc men
Medicine	dược phẩm
Medium	Trung bình
Meet	gặp
Meeting	gặp gỡ
Melt	tan chảy
Member	hội viên
Membership	thành viên
Memory	ký ức
Mental	tâm thần
Mentally	tinh thần
Mention	đề cập đến
Mentor	người cố vấn
Menu	thực đơn
Merchant	thương gia
Mere	chỉ là
Merely	đơn thuần
Merit	n
Mess	lộn xộn
Message	thông điệp
Metal	kim loại
Metaphor	phép ẩn dụ
Meter	mét
Method	phương pháp
Metropolitan	đô thị
Mexican	Mexico
Middle	ở giữa
Middle-class	tầng lớp trung lưu
Midnight	nữa đêm
Midst	giữa
Might	có thể
Migration	di cư
Mild	nhẹ nhàng
Military	quân đội
Milk	Sữa
Mill	cối xay
Million	triệu
Mind	lí trí
Mine	tôi
Mineral	khoáng sản
Minimal	tối thiểu
Minimize	giảm thiểu
Minimum	tối thiểu
Minister	bộ trưởng, mục sư
Ministry	Bộ
Minor	diễn viên phụ
Minority	thiểu số
Minute	phút
Miracle	phép màu
Mirror	gương
Miss	bỏ lỡ
Missile	tên lửa
Missing	mất tích
Mission	sứ mệnh
Missionary	nhà truyền giáo
Mistake	sai lầm
Mix	pha trộn
Mixed	pha trộn
Mixture	hỗn hợp
Mm-hmm	mm-hmm
Mobile	di động
Mode	chế độ
Model	mô hình
Moderate	vừa phải
Modern	hiện đại
Modest	khiêm tốn
Modify	sửa đổi
Molecule	phân tử
Mom	mẹ
Moment	chốc lát
Momentum	Đà
Money	tiền bạc
Monitor	giám sát
Monkey	con khỉ
Monster	quái vật
Month	tháng
Monthly	hàng tháng
Monument	tượng đài
Mood	khí sắc
Moon	mặt trăng
Moral	đạo đức
More	hơn
Moreover	hơn thế nữa
Morning	buổi sáng
Mortality	tử vong
Mortgage	thế chấp
Most	phần lớn
Mostly	chủ yếu
Mother	mẹ
Motion	chuyển động
Motivate	động viên
Motivation	động lực
Motive	động cơ
Motor	động cơ
Mount	gắn kết
Mountain	núi
Mouse	chuột
Mouth	miệng
Move	di chuyển
Movement	phong trào
Movie	bộ phim
Mr	Ông
Mrs	Bà
Ms	Cô
Much	nhiều
Mud	bùn
Multiple	nhiều
Municipal	thành phố
Murder	giết người
Muscle	cơ bắp
Museum	viện bảo tàng
Mushroom	nấm
Music	Âm nhạc
Musical	âm nhạc
Musician	nhạc sĩ
Muslim	Hồi giáo
Must	phải
Mutter	lẩm bẩm
Mutual	lẫn nhau
My	tôi
Myself	riêng tôi
Mysterious	huyền bí
Mystery	huyền bí
Myth	huyền thoại
N't	không
Nail	móng tay
Naked	trần truồng
Name	Tên
Narrative	tường thuật
Narrow	hẹp
Nasty	bẩn thỉu
Nation	quốc gia
National	Quốc gia
Nationwide	toàn quốc
Native	tự nhiên
Natural	tự nhiên
Naturally	một cách tự nhiên
Nature	thiên nhiên
Naval	hải quân
Near	ở gần
Nearby	gần đó
Nearly	Gần
Neat	khéo léo
Necessarily	nhất thiết
Necessary	cần thiết
Necessity	sự cần thiết
Neck	cái cổ
Need	nhu cầu
Needle	cây kim
Negative	tiêu cực
Negotiate	đàm phán
Negotiation	đàm phán
Neighbor	hàng xóm
Neighborhood	khu vực lân cận
Neighboring	lân cận
Neither	cũng không
Nerve	dây thần kinh
Nervous	lo lắng
Nest	tổ
Net	mạng lưới
Network	mạng
Neutral	Trung tính
Never	không bao giờ
Nevertheless	Tuy nhiên
New	Mới
Newly	mới
News	Tin tức
Newspaper	báo chí
Next	kế tiếp
Nice	tốt đẹp
Night	đêm
Nightmare	ác mộng
Nine	chín
No	Không
Nobody	không ai
Nod	gật đầu
Noise	tiếng ồn
Nomination	đề cử
Nominee	ứng cử viên
None	không ai
Nonetheless	dù sao
Nonprofit	phi lợi nhuận
Noon	trưa
Nor	cũng không
Norm	định mức
Normal	bình thường
Normally	bình thường
North	Bắc
Northeast	đông bắc
Northern	Phương bắc
Northwest	Tây Bắc
Nose	mũi
Not	không phải
Note	chú thích
Notebook	sổ tay
Nothing	không có gì
Notice	để ý
Notion	khái niệm
Novel	cuốn tiểu thuyết
Now	hiện nay
Nowhere	hư không
Nuclear	Nguyên tử
Number	con số
Numerous	nhiều
Nurse	y tá
Nut	hạt
Nutrient	chất dinh dưỡng
O'clock	giờ
Oak	cây sồi
Object	vật
Objection	sự phản đối
Objective	mục tiêu
Obligation	nghĩa vụ
Observation	quan sát
Observe	quan sát
Observer	người quan sát
Obstacle	trở ngại
Obtain	đạt được
Obvious	hiển nhiên
Obviously	chắc chắn
Occasion	dịp
Occasional	thỉnh thoảng
Occasionally	thỉnh thoảng
Occupation	nghề nghiệp
Occupy	chiếm
Occur	xảy ra
Ocean	đại dương
Odd	lẻ
Odds	tỷ lệ
Of	của
Off	tắt
Offender	tội phạm
Offense	xúc phạm
Offensive	phản cảm
Offer	phục vụ
Offering	chào bán
Office	văn phòng
Officer	nhân viên văn phòng
Official	chính thức
Officially	chính thức
Often	thường xuyên
Oh	Oh
Oil	dầu
Ok	được
Okay	đuợc
Old	cũ
Old-fashioned	Cổ hủ
Olympic	Olympic
Olympics	Thế vận hội
On	trên
Once	Một lần
One	một
One-third	một phần ba
Ongoing	đang diễn ra
Onion	củ hành
Online	Trực tuyến
Only	chỉ có
Onto	trên
Open	mở
Opening	khai mạc
Openly	cởi mở
Opera	opera
Operate	vận hành
Operating	điều hành
Operation	hoạt động
Operator	nhà điều hành
Opinion	quan điểm
Opponent	phản đối
Opportunity	cơ hội
Oppose	phản đối
Opposed	phản đối
Opposite	đối diện
Opposition	Sự đối lập
Opt	opt
Optimistic	lạc quan
Option	Tùy chọn
Or	hoặc là
Oral	miệng
Orange	trái cam
Orbit	quỹ đạo
Order	gọi món
Ordinary	bình thường
Organ	đàn organ
Organic	hữu cơ
Organism	cơ thể
Organization	cơ quan
Organizational	tổ chức
Organize	tổ chức
Organized	tổ chức
Orientation	sự định hướng
Origin	gốc
Original	nguyên
Originally	ban đầu
Other	khác
Others	Khác
Otherwise	nếu không thì
Ought	nên
Our	của chúng ta
Ours	của chúng tôi
Ourselves	chúng ta
Out	ngoài
Outcome	kết quả
Outdoor	ngoài trời
Outer	bên ngoài
Outfit	trang phục
Outlet	đầu ra
Outline	đề cương
Output	đầu ra
Outside	ở ngoài
Outsider	người ngoài
Outstanding	nổi bật
Oven	lò nướng
Over	kết thúc
Overall	tổng thể
Overcome	vượt qua
Overlook	bỏ qua
Overnight	qua đêm
Oversee	giám sát
Overwhelm	quá tải
Overwhelming	áp đảo
Owe	nợ
Own	sở hữu
Owner	chủ nhân
Ownership	sở hữu
Oxygen	ôxy
Pace	tốc độ
Pack	đóng gói
Package	gói
Pad	tập giấy
Page	trang
Pain	đau đớn
Painful	đau đớn
Paint	Sơn
Painter	họa sĩ
Painting	bức vẽ
Pair	đôi
Palace	cung điện
Pale	nhợt nhạt
Palestinian	Palestine
Palm	lòng bàn tay
Pan	chảo
Panel	bảng điều khiển
Panic	hoảng loạn
Pants (pl)	quần (PL)
Paper	giấy
Parade	diễu hành
Parent	cha mẹ
Parental	cha mẹ
Parish	giáo xứ
Park	công viên
Parking	bãi đỗ xe
Part	phần
Partial	một phần
Partially	một phần
Participant	người tham gia
Participate	tham dự
Participation	sự tham gia
Particle	hạt
Particular	cụ thể
Particularly	đặc biệt
Partly	từng phần
Partner	cộng sự
Partnership	hợp tác
Party	buổi tiệc
Pass	vượt qua
Passage	đoạn văn
Passenger	hành khách
Passing	đi qua
Passion	niềm đam mê
Past	quá khứ
Pasta	mỳ ống
Pastor	mục sư
Pat	vỗ vỗ
Patch	vá
Patent	bằng sáng chế
Path	con đường
Patience	kiên nhẫn
Patient	bệnh nhân
Patrol	tuần tra
Patron	người bảo trợ
Pattern	mẫu
Pause	tạm ngừng
Pay	trả
Payment	thanh toán
Pc	PC
Peace	hòa bình
Peaceful	bình yên
Peak	cao điểm
Peanut	đậu phụng
Peasant	nông dân
Peel	lột vỏ
Peer	ngang nhau
Pen	cây bút
Penalty	hình phạt
Pencil	bút chì
Pension	lương hưu
People	những người
Pepper	tiêu
Per	mỗi
Perceive	nhận thức
Perceived	lĩnh hội
Percentage	phần trăm
Perception	nhận thức
Perfect	hoàn hảo
Perfectly	hoàn hảo
Perform	biểu diễn
Performance	hiệu suất
Performer	người biểu diễn
Perhaps	có lẽ
Period	giai đoạn
Permanent	dài hạn
Permission	sự cho phép
Permit	cho phép
Persian	Người Ba Tư
Persist	tồn tại
Person	người
Personal	cá nhân
Personality	nhân cách
Personally	cá nhân
Personnel	nhân viên
Perspective	quan điểm
Persuade	truy vấn
Pet	vật nuôi
Phase	giai đoạn
Phenomenon	hiện tượng
Philosophical	triết học
Philosophy	triết học
Phone	điện thoại
Photo	hình chụp
Photograph	ảnh chụp
Photographer	nhiếp ảnh gia
Photography	nhiếp ảnh
Phrase	cụm từ
Physical	vật lý
Physically	thể chất
Physician	bác sĩ
Physics	vật lý
Piano	đàn piano
Pick	chọn
Pickup	nhặt lên
Picture	hình ảnh
Pie	chiếc bánh
Piece	cái
Pig	con lợn
Pile	Đóng cọc
Pill	Viên thuốc
Pillow	cái gối
Pilot	Phi công
Pin	ghim
Pine	cây thông
Pink	hồng
Pioneer	người tiên phong
Pipe	ống
Pistol	súng lục
Pit	hố
Pitch	sân cỏ
Pitcher	người bình
Pizza	pizza
Place	địa điểm
Placement	vị trí
Plain	trơn
Plaintiff	nguyên đơn
Plan	kế hoạch
Plane	máy bay
Planet	hành tinh
Planner	lập kế hoạch
Planning	lập kế hoạch
Plant	thực vật
Plastic	nhựa
Plate	đĩa
Platform	nền tảng
Play	chơi
Player	người chơi
Playoff	playoff
Plea	lời bào chữa
Plead	biện hộ
Pleasant	dễ chịu
Please	xin vui lòng
Pleased	vừa lòng
Pleasure	vui lòng
Plenty	nhiều
Plot	âm mưu
Plunge	lao xuống
Plus	thêm
Pm	PM
Pocket	bỏ túi
Poem	bài thơ
Poet	bài thơ
Poetry	thơ phú
Point	điểm
Poke	xô
Pole	cây sào
Police	cảnh sát
Policeman	cảnh sát
Policy	chính sách
Political	chính trị
Politically	chính trị
Politician	chính trị gia
Politics	chính trị
Poll	thăm dò ý kiến
Pollution	sự ô nhiễm
Pond	ao
Pool	bơi
Poor	nghèo nàn
Pop	nhạc pop
Popular	phổ biến
Popularity	phổ biến
Population	dân số
Porch	hiên nhà
Pork	thịt heo
Port	Hải cảng
Portfolio	danh mục đầu tư
Portion	phần
Portrait	Chân dung
Portray	miêu tả
Pose	đặt ra
Position	Chức vụ
Positive	tích cực
Possess	sở hữu
Possession	chiếm hữu
Possibility	khả năng
Possible	khả thi
Possibly	có thể
Post	bài đăng
Poster	áp phích
Pot	nồi
Potato	khoai tây
Potential	tiềm năng
Potentially	có khả năng
Pound	pao
Pour	đổ
Poverty	nghèo nàn
Powder	bột
Power	quyền lực
Powerful	quyền lực
Practical	thiết thực
Practically	thực tế
Practice	thực hành
Practitioner	học viên
Praise	ca ngợi
Pray	cầu nguyện
Prayer	cầu nguyện
Preach	rao giảng
Precious	quí
Precise	tóm lược
Precisely	đúng
Predator	người ăn thịt
Predict	tiên đoán
Prediction	dự đoán
Prefer	thích hơn
Preference	sở thích
Pregnancy	mang thai
Pregnant	có thai
Preliminary	sơ bộ
Premise	tiền đề
Premium	phí bảo hiểm
Preparation	chuẩn bị
Prepare	chuẩn bị
Prescription	đơn thuốc
Presence	sự hiện diện
Present	hiện tại
Presentation	trình bày
Preserve	giữ gìn
Presidency	chức tổng thống
President	chủ tịch
Presidential	tổng thống
Press	nhấn
Pressure	sức ép
Presumably	có lẽ
Pretend	giả vờ
Pretty	đẹp
Prevail	chiếm ưu thế
Prevent	ngăn chặn
Prevention	Phòng ngừa
Previous	Trước
Previously	trước đây
Price	giá bán
Pride	tự hào
Priest	thầy tu
Primarily	chủ yếu
Primary	sơ cấp
Prime	nguyên tố
Principal	hiệu trưởng
Principle	nguyên tắc
Print	in
Prior	trước
Priority	sự ưu tiên
Prison	nhà tù
Prisoner	Tù nhân
Privacy	riêng tư
Privately	tư nhân
Privilege	đặc quyền
Prize	giải thưởng
Pro	pro
Probably	có lẽ
Problem	vấn đề
Procedure	thủ tục
Proceed	tiếp tục
Process	quá trình
Processing	Chế biến
Processor	bộ vi xử lý
Proclaim	tuyên bố
Produce	sản xuất
Producer	nhà sản xuất
Product	sản phẩm
Production	sản xuất
Productive	có năng suất
Productivity	năng suất
Profession	chuyên nghiệp
Professional	chuyên nghiệp
Professor	Giáo sư
Profile	Hồ sơ
Profit	lợi nhuận
Profound	thâm thúy
Program	chương trình
Programming	lập trình
Progress	tiến độ
Progressive	cấp tiến
Prohibit	cấm
Project	dự án
Projection	chiếu
Prominent	nổi bật
Promise	lời hứa
Promising	hứa hẹn
Promote	Quảng bá
Promotion	quảng cáo
Prompt	nhắc nhở
Proof	bằng chứng
Proper	phù hợp
Properly	đúng
Property	bất động sản
Proportion	tỉ lệ
Proposal	đề nghị
Propose	cầu hôn
Proposed	đề xuất
Prosecution	truy tố
Prosecutor	công tố viên
Prospect	khách hàng tiềm năng
Protect	bảo vệ
Protection	sự bảo vệ
Protective	bảo vệ
Protein	chất đạm
Protest	phản đối
Protocol	giao thức
Proud	tự hào
Prove	chứng minh
Provide	cung cấp
Provided	cung cấp
Provider	các nhà cung cấp
Province	tỉnh
Provision	điều khoản
Provoke	kích động
Psychological	tâm lý
Psychologist	nhà tâm lý học
Psychology	tâm lý học
Public	công cộng
Publication	xuất bản
Publicity	công khai
Publicly	công khai
Publish	công bố
Publisher	nhà xuất bản
Pull	kéo
Pulse	xung
Pump	máy bơm
Punch	đấm
Punish	trừng phạt
Punishment	hình phạt
Purchase	mua, tựa vào, bám vào
Pure	nguyên chất
Purple	màu tím
Purpose	mục đích
Purse	cái ví
Pursue	theo đuổi
Pursuit	theo đuổi
Push	đẩy
Put	đặt
Puzzle	câu đố
Qualify	đủ tiêu chuẩn
Quality	phẩm chất
Quantity	số lượng
Quarter	phần tư
Quarterback	tiền vệ
Queen	nữ hoàng
Quest	nhiệm vụ
Question	câu hỏi
Questionnaire	bảng câu hỏi
Quick	nhanh chóng
Quickly	Mau
Quiet	Yên tĩnh
Quietly	lặng lẽ
Quit	thoái lui
Quite	khá
Quote	Trích dẫn
Rabbit	Con thỏ
Race	cuộc đua
Racial	chủng tộc
Racism	chủ nghĩa phân biệt chủng tộc
Rack	giá đỡ
Radar	radar
Radiation	sự bức xạ
Radical	cấp tiến, căn nguyên
Radio	radio
Rage	giận dữ
Rail	đường sắt
Railroad	đường sắt
Rain	mưa
Raise	nâng cao
Rally	biểu tình
Ranch	trang trại
Random	ngẫu nhiên
Range	phạm vi
Rank	cấp
Rape	hãm hiếp
Rapid	nhanh
Rapidly	nhanh chóng
Rare	hiếm
Rarely	ít khi
Rat	con chuột
Rate	tỷ lệ
Rather	hơn
Rating	Xêp hạng
Ratio	tỉ lệ
Rational	hợp lý
Raw	thô
Re	lại
Reach	chạm tới
React	phản ứng
Reaction	phản ứng
Read	đọc
Reader	người đọc
Readily	dễ dàng
Reading	đọc hiểu
Ready	sẳn sàng
Real	thực
Realistic	thực tế
Reality	thực tế
Realize	nhận ra
Really	có thật không
Realm	cảnh giới
Rear	phía sau
Reason	lý do
Reasonable	hợp lý
Rebel	nổi loạn
Rebuild	xây dựng lại
Recall	hồi tưởng
Receive	nhận được
Receiver	người nhận
Recent	gần đây
Recently	gần đây
Reception	tiếp nhận
Recession	suy thoái kinh tế
Recipe	công thức
Recipient	người nhận
Recognition	sự công nhận
Recognize	nhìn nhận
Recommend	giới thiệu
Recommendation	sự giới thiệu
Record	ghi lại
Recording	ghi âm
Recover	bình phục
Recovery	phục hồi
Recruit	tuyển dụng
Red	đỏ
Reduce	giảm
Reduction	giảm
Refer	tham khảo
Reference	tài liệu tham khảo
Reflect	phản chiếu
Reflection	sự phản chiếu
Reform	cải cách
Refrigerator	tủ lạnh
Refuge	nơi ẩn náu
Refugee	người tị nạn
Refuse	từ chối
Regain	giành lại
Regard	quan tâm
Regarding	về
Regardless	bất kể
Regime	chế độ
Region	khu vực
Regional	khu vực
Register	ghi danh
Regret	hối tiếc
Regular	đều đặn
Regularly	thường xuyên
Regulate	quy định
Regulation	Quy định
Regulator	người điều tiết
Regulatory	quy định
Rehabilitation	phục hồi chức năng
Reinforce	củng cố
Reject	Từ chối
Relate	liên hệ
Related	liên quan
Relation	quan hệ
Relationship	mối quan hệ
Relative	quan hệ
Relatively	tương đối
Relax	thư giãn
Release	giải phóng
Relevant	liên quan, thích hợp
Reliability	độ tin cậy
Reliable	đáng tin cậy
Relief	cứu trợ
Relieve	giải tỏa
Religion	tôn giáo
Religious	Tôn giáo
Reluctant	lưỡng lự
Rely	dựa
Remain	vẫn còn
Remaining	còn lại
Remark	nhận xét
Remarkable	đáng chú ý
Remember	nhớ lại
Remind	nhắc lại
Reminder	nhắc nhở
Remote	xa
Removal	gỡ bỏ
Remove	tẩy
Render	render
Rent	thuê
Rental	thuê
Repair	sửa
Repeat	nói lại
Repeatedly	nhiều lần
Replace	thay thế
Replacement	thay thế
Reply	Đáp lại
Report	bài báo cáo
Reportedly	báo cáo
Reporter	phóng viên
Reporting	Báo cáo
Represent	đại diện
Representation	đại diện
Representative	Tiêu biểu
Republic	nước cộng hòa
Republican	nhà nước cộng hòa
Reputation	uy tín
Request	yêu cầu
Require	yêu cầu
Required	cần thiết
Requirement	yêu cầu
Rescue	cứu hộ
Research	nghiên cứu
Researcher	nghiên cứu viên
Resemble	giống
Reservation	đặt phòng
Reserve	dự trữ
Residence	nơi cư trú
Resident	cư dân
Residential	nhà ở
Resign	từ chức
Resist	kháng cự
Resistance	sức đề kháng
Resolution	độ phân giải
Resolve	giải quyết
Resort	phương sách
Resource	tài nguyên
Respect	sự tôn trọng
Respectively	tương ứng
Respond	trả lời
Respondent	người trả lời
Response	phản ứng
Responsibility	trách nhiệm
Responsible	chịu trách nhiệm
Rest	nghỉ ngơi
Restaurant	nhà hàng
Restore	phục hồi
Restrict	giới hạn
Restriction	sự hạn chế
Result	kết quả
Resume	tiếp tục
Retail	bán lẻ
Retailer	nhà bán lẻ
Retain	giữ lại
Retire	về hưu
Retired	nghỉ hưu
Retirement	nghỉ hưu
Retreat	rút lui
Return	trở về
Reveal	tiết lộ
Revelation	sự mặc khải
Revenue	thu nhập
Reverse	đảo ngược
Review	ôn tập
Revolution	Cuộc cách mạng
Revolutionary	cách mạng
Reward	phần thưởng
Rhetoric	Hùng biện
Rhythm	nhịp
Rib	xương sườn
Ribbon	ribbon
Rice	cơm
Rich	giàu có
Rid	thoát khỏi
Ride	dap xe
Rider	người lái
Ridge	cây rơm
Ridiculous	nực cười
Rifle	súng trường
Right	đúng
Rim	rim
Ring	nhẫn
Riot	bạo loạn
Rip	Yên nghỉ
Rise	tăng lên
Risk	rủi ro
Risky	rủi ro
Ritual	lễ nghi
Rival	đối thủ
River	con sông
Road	đường
Robot	robot
Rock	đá
Rocket	tên lửa
Rod	gậy
Role	vai trò
Roll	cuộn
Rolling	lăn
Roman	Roman
Romance	lãng mạn
Romantic	lãng mạn
Roof	mái nhà
Room	phòng
Root	nguồn gốc
Rope	dây thừng
Rose	bông hồng
Rough	thô
Roughly	gần
Round	tròn
Route	lộ trình
Routine	công Việt Hằng ngày
Routinely	thường
Row	hàng
Royal	hoàng tộc
Rub	chà xát
Rubber	cao su
Ruin	phá hoại
Rule	qui định
Ruling	phán quyết
Rumor	tin đồn
Run	chạy
Runner	người chạy
Running	đang chạy
Rural	nông thôn
Rush	vội vã
Russian	Người Nga
Sack	bao
Sacred	Linh thiêng
Sacrifice	sự hy sinh
Sad	buồn
Safe	an toàn
Safely	an toàn
Safety	an toàn
Sail	cánh buồm
Sake	lợi ích
Salad	rau xà lách
Salary	lương
Sale	buôn bán
Sales	bán hàng
Salmon	cá hồi
Salt	Muối
Same	tương tự
Sample	mẫu vật
Sanction (pl)	sự trừng phạt (PL)
Sand	cát
Sandwich	sandwich
Satellite	vệ tinh
Satisfaction	sự thỏa mãn
Satisfy	làm vui lòng
Sauce	Nước xốt
Save	tiết kiệm
Saving (pl)	tiết kiệm (PL)
Say	Nói
Scale	tỉ lệ
Scan	quét
Scandal	vụ bê bối
Scare	sợ hãi
Scared	sợ hãi
Scary	đáng sợ
Scatter	tiêu tan
Scenario	kịch bản
Scene	bối cảnh
Scent	hương thơm
Schedule	kế hoạch
Scheme	kế hoạch
Scholar	học giả
Scholarship	học bổng
School	trường học
Science	khoa học
Scientific	thuộc về khoa học
Scientist	nhà khoa học
Scope	phạm vi
Score	ghi bàn
Scramble	tranh giành
Scratch	vết trầy
Scream	hét lên
Screen	màn
Screening	kiểm tra
Screw	Đinh ốc
Script	kịch bản
Sculpture	điêu khắc
Sea	biển
Seal	niêm phong
Search	Tìm kiếm
Season	Mùa
Seat	ghế
Second	thứ hai
Secondary	thứ hai
Secret	bí mật
Secretary	Thư ký
Section	phần
Sector	ngành
Secular	thế tục
Secure	đảm bảo
Security	Bảo vệ
See	xem
Seed	giống
Seek	tìm kiếm
Seem	hình như
Seemingly	có vẻ
Segment	phần
Seize	tịch thu
Seldom	ít khi
Select	lựa chọn
Selected	đã chọn
Selection	lựa chọn
Self	tự
Self-esteem	lòng tự trọng
Sell	bán
Seller	người bán
Seminar	hội thảo
Senate	Thượng nghị viện
Senator	thượng nghị sĩ
Send	gửi
Senior	cao cấp
Sensation	cảm giác
Sense	giác quan
Sensitive	nhạy cảm
Sensitivity	nhạy cảm
Sensor	cảm biến
Sentence	kết án
Sentiment	tình cảm
Separate	tách rời
Separation	tách biệt
Sequence	trình tự
Series	loạt
Serious	nghiêm trọng
Seriously	nghiêm túc
Servant	người hầu
Serve	phục vụ
Service	dịch vụ
Serving	phục vụ
Session	phiên họp
Set	bộ
Setting	cài đặt
Settle	ổn định
Settlement	giải quyết
Seven	bảy
Seventh	thứ bảy
Several	một số
Severe	nghiêm trọng
Severely	nghiêm trọng
Sex	tình dục
Sexual	tình dục
Sexuality	tình dục
Sexually	tình dục
Sexy	sexy
Shade	bóng râm
Shadow	bóng
Shake	lắc
Shall	sẽ
Shallow	nông
Shame	xấu hổ
Shape	hình dạng
Share	chia sẻ
Shared	chia sẻ
Shareholder	cổ đông
Shark	cá mập
Sharp	nhọn
Sharply	mạnh
She	chị ấy
Shed	đổ ra
Sheep	cừu
Sheer	tuyệt
Sheet	tấm
Shelf	kệ
Shell	vỏ
Shelter	nơi trú ẩn
Shift	sự thay đổi
Shine	tỏa sáng
Ship	tàu
Shirt	áo sơ mi
Shit	dơ bẩn
Shock	sốc
Shoe	giày
Shoot	bắn
Shooting	chụp
Shop	cửa tiệm
Shopping	mua sắm
Shore	bờ biển
Short	ngắn
Short-term	thời gian ngắn
Shortage	sự thiếu
Shortly	ngay
Shorts	quần short
Shot	bắn
Should	Nên
Shoulder	vai
Shout	kêu la
Shove	xô
Show	chỉ
Shower	vòi hoa sen
Shrimp	con tôm
Shrink	co lại
Shrug	nhún vai
Shut	đóng lại
Shuttle	đưa đón
Shy	nhát
Sibling	anh chị em ruột
Sick	đau ốm
Side	bên
Sidewalk	đường đi bộ
Sigh	thở dài
Sight	thị giác
Sign	ký tên
Signal	tín hiệu
Signature	Chữ ký
Significance	tầm quan trọng
Significant	có ý nghĩa
Significantly	đáng kể
Silence	khoảng lặng
Silent	im lặng
Silk	lụa
Silly	ngớ ngẩn
Silver	bạc
Similar	giống
Similarity	sự giống nhau
Similarly	tương tự
Simple	đơn giản
Simply	đơn giản
Simultaneously	đồng thời
Sin	tội
Since	kể từ
Sing	hát
Singer	ca sĩ
Single	Độc thân
Sink	bồn rửa
Sir	Ngài
Sister	em gái
Sit	ngồi
Site	địa điểm
Situation	tình hình
Six	sáu
Sixth	thứ sáu
Size	kích thước
Ski	trượt tuyết
Skill	kỹ năng
Skilled	có kỹ năng
Skin	da
Skip	bỏ qua
Skirt	váy
Skull	sọ
Sky	bầu trời
Slam	sập
Slap	tát
Slave	nô lệ
Slavery	chế độ nô lệ
Sleep	ngủ
Sleeve	tay áo
Slice	lát
Slide	trượt
Slight	nhẹ
Slightly	khinh bỉ
Slip	trượt
Slope	dốc
Slot	khe
Slow	chậm
Slowly	chậm rãi
Small	nhỏ bé
Smart	thông minh
Smell	mùi
Smile	nụ cười
Smoke	hút thuốc lá
Smooth	trơn tru
Snake	con rắn
Snap	chụp nhanh
Sneak	sneak
Snow	tuyết
So	vì thế
So-called	cái gọi là
Soak	ngâm
Soap	xà bông
Soar	bay lên
Soccer	bóng đá
Social	xã hội
Socially	xã hội
Society	xã hội
Sock	bít tất
Sodium	natri
Sofa	ghế sô pha
Soft	mềm mại
Soften	làm mềm
Softly	nhẹ nhàng
Software	phần mềm
Soil	đất
Solar	hệ mặt trời
Soldier	lính
Sole	Duy Nhất
Solely	chỉ
Solid	chất rắn
Solution	dung dịch
Solve	giải quyết
Some	một số
Somebody	có ai
Someday	một ngày nào đó
Somehow	bằng cách nào đó
Someone	người nào
Something	cái gì đó
Sometime	thỉnh thoảng
Sometimes	đôi khi
Somewhat	phần nào
Somewhere	một vài nơi
Son	Con trai
Song	bài hát
Soon	Sớm
Sophisticated	tinh vi
Sorry	lấy làm tiếc
Sort	sắp xếp
Soul	Linh hồn
Sound	âm thanh
Soup	Súp
Source	nguồn
South	miền Nam
Southeast	Đông Nam
Southern	phía Nam
Southwest	tây nam
Sovereignty	chủ quyền
Soviet	Liên Xô
Space	không gian
Spanish	người Tây Ban Nha
Spare	phụ tùng
Spark	tia lửa
Speak	nói
Speaker	loa
Special	đặc biệt
Specialist	chuyên gia
Specialize	chuyên môn hóa
Specialty	chuyên môn
Species	loài
Specific	riêng
Specifically	đặc biệt
Specify	chỉ định
Spectacular	đẹp mắt
Spectrum	quang phổ
Speculate	suy đoán
Speculation	suy đoán
Speech	phát biểu
Speed	tốc độ
Spell	Đánh vần
Spend	tiêu
Spending	chi tiêu
Sphere	quả cầu
Spill	tràn
Spin	quay
Spine	xương sống
Spirit	tinh thần
Spiritual	tinh thần
Spit	nhổ
Spite	bất bình
Split	phân chia
Spokesman	người phát ngôn
Sponsor	nhà tài trợ
Spoon	cái thìa
Sport	môn thể thao
Spot	nơi
Spouse	vợ / chồng
Spray	Xịt nước
Spread	Lan tràn
Spring	mùa xuân
Sprinkle	rắc
Spy	gián điệp
Squad	đội hình
Square	Quảng trường
Squeeze	bóp
Stability	sự ổn định
Stable	ổn định
Stack	cây rơm
Stadium	sân vận động
Staff	cán bộ
Stage	sân khấu
Stair	cầu thang
Stake	cổ phần
Stance	lập trường
Stand	đứng
Standard	Tiêu chuẩn
Standing	đứng
Star	ngôi sao
Stare	nhìn chằm chằm
Start	khởi đầu
Starter	bắt đầu
Starting	bắt đầu
State	tiểu bang
Statement	tuyên bố
Station	ga tàu
Statistical	thống kê
Statistics	số liệu thống kê
Statue	bức tượng
Status	trạng thái
Statute	đạo luật
Stay	ở lại
Steadily	liên tục
Steady	vững chắc
Steak	miếng bò hầm
Steal	lấy trộm
Steam	hơi nước
Steel	Thép
Steep	dốc
Steer	chỉ đạo
Stem	thân cây
Step	bậc thang
Stereotype	khuôn mẫu
Stick	gậy
Stiff	cứng
Still	vẫn
Stimulate	kích thích
Stimulus	kích thích kinh tế
Stir	khuấy
Stock	cổ phần
Stomach	Dạ dày
Stone	Cục đá
Stop	dừng lại
Storage	lưu trữ
Store	cửa hàng
Storm	bão táp
Story	câu chuyện
Stove	bếp
Straight	thẳng
Straighten	làm thẳng
Strain	sự căng thẳng, quá tải
Strange	kỳ lạ
Stranger	lạ
Strategic	chiến lược
Strategy	chiến lược
Straw	Rơm rạ
Streak	streak
Stream	suối
Street	đường phố
Strength	sức mạnh
Strengthen	củng cố
Stress	nhấn mạnh, cẳng thẳng
Stretch	căng ra
Strict	nghiêm khắc
Strictly	nghiêm khắc
Strike	đình công
Striking	nổi bật
String	chuỗi
Strip	dải
Stroke	Cú đánh
Strong	mạnh
Strongly	mạnh mẽ
Structural	cấu trúc
Structure	kết cấu
Struggle	đấu tranh
Student	sinh viên
Studio	studio
Study	học
Stuff	đồ đạc
Stumble	tình cờ gặp
Stupid	ngốc nghếch
Style	Phong cách
Subject	môn học
Submit	đệ trình
Subsequent	sau đó
Subsidy	trợ cấp
Substance	vật chất
Substantial	đáng kể
Subtle	tế nhị
Suburb	ngoại ô
Suburban	ngoại ô
Succeed	thành công
Success	sự thành công
Successful	thành công
Successfully	thành công
Such	như là
Suck	hút
Sudden	đột nhiên
Suddenly	đột ngột
Sue	kiện
Suffer	đau khổ
Suffering	đau khổ
Sufficient	đủ
Sugar	đường
Suggest	đề nghị
Suggestion	gợi ý
Suicide	tự tử
Suit	bộ đồ
Suitable	thích hợp
Suite	suite
Sum	tổng hợp
Summary	tóm lược
Summer	mùa hè
Summit	hội nghị thượng đỉnh
Sun	mặt trời
Sunlight	ánh sáng mặt trời
Sunny	nắng
Super	siêu
Superior	cấp trên
Supermarket	siêu thị
Supervisor	người giám sát
Supplier	nhà cung cấp
Supply	cung cấp
Support	ủng hộ
Supporter	người ủng hộ
Supportive	hỗ trợ
Suppose	giả sử
Supposed	giả định
Supposedly	được cho là
Supreme	Tối cao
Sure	chắc chắn rồi
Surely	chắc chắn
Surface	bề mặt
